codigo_ibge,UF-Munic√≠pio,anomes_s,qtd_pes_pob,qtd_pes_baixa_renda,qtd_pes_acima_meio_sm,total,pop. IBGE 2024,% no cad unico,% pobreza
110001,Ro-Alta Floresta D Oeste,202503,4074,3761,3887,11722,22.853,"51,29%","17,83%"
110002,Ro-Ariquemes,202503,17883,12715,13704,44302,108.573,"40,80%","16,47%"
110003,Ro-Cabixi,202503,730,1001,1003,2734,5.690,"48,05%","12,83%"
110004,Ro-Cacoal,202503,13001,12667,14941,40609,97.637,"41,59%","13,32%"
110005,Ro-Cerejeiras,202503,2906,2138,2394,7438,16.975,"43,82%","17,12%"
110006,Ro-Colorado do Oeste,202503,1108,1962,2293,5363,16.588,"32,33%","6,68%"
110007,Ro-Corumbiara,202503,618,1300,1408,3326,8.001,"41,57%","7,72%"
110008,Ro-Costa Marques,202503,5235,2106,1976,9317,13.522,"68,90%","38,71%"
110009,Ro-Espigao D Oeste,202503,3230,5684,4577,13491,32.717,"41,24%","9,87%"
110010,Ro-Guajara-Mirim,202503,15530,6254,4756,26540,43.553,"60,94%","35,66%"
110011,Ro-Jaru,202503,7296,8574,8075,23945,55.583,"43,08%","13,13%"
110012,Ro-Ji-Parana,202503,17448,16420,18561,52429,139.359,"37,62%","12,52%"
110013,Ro-Machadinho D Oeste,202503,6308,6886,7323,20517,34.063,"60,23%","18,52%"
110014,Ro-Nova Brasilandia D Oeste,202503,3146,3383,3199,9728,16.504,"58,94%","19,06%"
110015,Ro-Ouro Preto do Oeste,202503,5395,5510,5683,16588,38.681,"42,88%","13,95%"
110018,Ro-Pimenta Bueno,202503,3188,4591,5802,13581,39.053,"34,78%","8,16%"
110020,Ro-Porto Velho,202503,124413,60908,64300,249621,514.873,"48,48%","24,16%"
110025,Ro-Presidente Medici,202503,4594,3498,4847,12939,20.518,"63,06%","22,39%"
110026,Ro-Rio Crespo,202503,543,728,730,2001,3.753,"53,32%","14,47%"
110028,Ro-Rolim de Moura,202503,4421,8562,8787,21770,62.559,"34,80%","7,07%"
110029,Ro-Santa Luzia D Oeste,202503,1438,1177,1666,4281,7.877,"54,35%","18,26%"
110030,Ro-Vilhena,202503,10860,13739,16235,40834,108.528,"37,63%","10,01%"
110032,Ro-Sao Miguel do Guapore,202503,2729,3666,4679,11074,22.267,"49,73%","12,26%"
110033,Ro-Nova Mamore,202503,7456,4754,3623,15833,28.496,"55,56%","26,17%"
110034,Ro-Alvorada D Oeste,202503,3348,2449,2235,8032,13.837,"58,05%","24,20%"
110037,Ro-Alto Alegre dos Parecis,202503,756,2150,1737,4643,12.263,"37,86%","6,16%"
110040,Ro-Alto Paraiso,202503,2898,3370,2988,9256,17.463,"53,00%","16,60%"
110045,Ro-Buritis,202503,5112,4203,3972,13287,30.729,"43,24%","16,64%"
110050,Ro-Novo Horizonte do Oeste,202503,1231,1830,1732,4793,8.056,"59,50%","15,28%"
110060,Ro-Cacaulandia,202503,697,1077,1288,3062,4.345,"70,47%","16,04%"
110070,Ro-Campo Novo de Rondonia,202503,1272,1821,1590,4683,9.225,"50,76%","13,79%"
110080,Ro-Candeias do Jamari,202503,9302,3851,4166,17319,24.163,"71,68%","38,50%"
110090,Ro-Castanheiras,202503,653,585,636,1874,3.456,"54,22%","18,89%"
110092,Ro-Chupinguaia,202503,2278,1281,1484,5043,10.129,"49,79%","22,49%"
110094,Ro-Cujubim,202503,3055,3532,2826,9413,15.883,"59,26%","19,23%"
110100,Ro-Governador Jorge Teixeira,202503,2067,2223,1387,5677,8.420,"67,42%","24,55%"
110110,Ro-Itapua do Oeste,202503,1788,2050,1661,5499,9.209,"59,71%","19,42%"
110120,Ro-Ministro Andreazza,202503,1572,1170,1354,4096,6.657,"61,53%","23,61%"
110130,Ro-Mirante da Serra,202503,1982,2106,2376,6464,9.740,"66,37%","20,35%"
110140,Ro-Monte Negro,202503,3587,2284,2316,8187,12.241,"66,88%","29,30%"
110143,Ro-Nova Uniao,202503,1873,1233,1382,4488,6.577,"68,24%","28,48%"
110145,Ro-Parecis,202503,915,767,1089,2771,4.390,"63,12%","20,84%"
110146,Ro-Pimenteiras do Oeste,202503,704,482,707,1893,2.311,"81,91%","30,46%"
110147,Ro-Primavera da Rondonia,202503,677,583,1167,2427,3.279,"74,02%","20,65%"
110148,Ro-Sao Felipe D Oeste,202503,454,892,1811,3157,5.605,"56,32%","8,10%"
110149,Ro-Sao Francisco do Guapore,202503,3436,3101,2735,9272,17.511,"52,95%","19,62%"
110150,Ro-Seringueiras,202503,2241,2930,2415,7586,12.954,"58,56%","17,30%"
110155,Ro-Teixeiropolis,202503,848,835,1104,2787,4.536,"61,44%","18,69%"
110160,Ro-Theobroma,202503,1349,1734,1717,4800,8.540,"56,21%","15,80%"
110170,Ro-Urupa,202503,2470,1372,1817,5659,11.377,"49,74%","21,71%"
110175,Ro-Vale do Anari,202503,2601,1845,2426,6872,8.265,"83,15%","31,47%"
110180,Ro-Vale do Paraiso,202503,1230,1261,1125,3616,6.843,"52,84%","17,97%"
120001,Ac-Acrelandia,202503,5825,2455,2205,10485,14.657,"71,54%","39,74%"
120005,Ac-Assis Brasil,202503,6484,1704,851,9039,8.573,"105,44%","75,63%"
120010,Ac-Brasileia,202503,13449,2978,2366,18793,27.841,"67,50%","48,31%"
120013,Ac-Bujari,202503,5223,2585,1558,9366,13.766,"68,04%","37,94%"
120017,Ac-Capixaba,202503,5168,1929,1746,8843,10.922,"80,97%","47,32%"
120020,Ac-Cruzeiro do Sul,202503,42053,12333,5821,60207,98.382,"61,20%","42,74%"
120025,Ac-Epitaciolandia,202503,7199,2245,1548,10992,19.739,"55,69%","36,47%"
120030,Ac-Feijo,202503,19008,6660,2123,27791,37.644,"73,83%","50,49%"
120032,Ac-Jordao,202503,6833,1301,611,8745,9.787,"89,35%","69,82%"
120033,Ac-Mancio Lima,202503,12754,2173,1233,16160,20.329,"79,49%","62,74%"
120034,Ac-Manoel Urbano,202503,7784,2204,1345,11333,12.776,"88,71%","60,93%"
120035,Ac-Marechal Thaumaturgo,202503,12512,2297,1260,16069,17.951,"89,52%","69,70%"
120038,Ac-Placido de Castro,202503,6138,2641,1873,10652,17.127,"62,19%","35,84%"
120039,Ac-Porto Walter,202503,7230,1610,843,9683,11.275,"85,88%","64,12%"
120040,Ac-Rio Branco,202503,102939,49989,38150,191078,387.852,"49,27%","26,54%"
120042,Ac-Rodrigues Alves,202503,9475,2122,1089,12686,15.537,"81,65%","60,98%"
120043,Ac-Santa Rosa do Purus,202503,4623,1023,659,6305,7.143,"88,27%","64,72%"
120045,Ac-Senador Guiomard,202503,8314,3563,2651,14528,22.352,"65,00%","37,20%"
120050,Ac-Sena Madureira,202503,26581,6393,3181,36155,43.916,"82,33%","60,53%"
120060,Ac-Tarauaca,202503,30277,7118,3203,40598,46.517,"87,28%","65,09%"
120070,Ac-Xapuri,202503,7795,2783,1950,12528,19.090,"65,63%","40,83%"
120080,Ac-Porto Acre,202503,11353,2506,2078,15937,17.455,"91,30%","65,04%"
130002,Am-Alvaraes,202503,10676,2256,1200,14132,16.670,"84,78%","64,04%"
130006,Am-Amatura,202503,8165,1103,1145,10413,11.411,"91,25%","71,55%"
130008,Am-Anama,202503,7880,1168,871,9919,10.318,"96,13%","76,37%"
130010,Am-Anori,202503,9964,1344,1186,12494,17.932,"69,67%","55,57%"
130014,Am-Apui,202503,6252,3229,2782,12263,21.735,"56,42%","28,76%"
130020,Am-Atalaia do Norte,202503,7660,3169,1320,12149,15.892,"76,45%","48,20%"
130030,Am-Autazes,202503,36117,2625,2902,41644,45.328,"91,87%","79,68%"
130040,Am-Barcelos,202503,10406,2097,1324,13827,18.626,"74,23%","55,87%"
130050,Am-Barreirinha,202503,21250,4937,2129,28316,33.436,"84,69%","63,55%"
130060,Am-Benjamin Constant,202503,25260,5211,2393,32864,40.509,"81,13%","62,36%"
130063,Am-Beruri,202503,17185,2964,1628,21777,22.136,"98,38%","77,63%"
130068,Am-Boa Vista do Ramos,202503,10656,1591,1142,13389,25.769,"51,96%","41,35%"
130070,Am-Boca do Acre,202503,16254,4344,2602,23200,38.246,"60,66%","42,50%"
130080,Am-Borba,202503,20821,3976,2177,26974,34.879,"77,34%","59,69%"
130083,Am-Caapiranga,202503,8229,980,935,10144,14.310,"70,89%","57,51%"
130090,Am-Canutama,202503,8030,2702,1432,12164,17.885,"68,01%","44,90%"
130100,Am-Carauari,202503,19339,3832,1971,25142,30.892,"81,39%","62,60%"
130110,Am-Careiro,202503,15034,5087,4119,24240,32.442,"74,72%","46,34%"
130115,Am-Careiro da Varzea,202503,12525,2418,1615,16558,19.809,"83,59%","63,23%"
130120,Am-Coari,202503,43792,7299,4559,55650,73.820,"75,39%","59,32%"
130130,Am-Codajas,202503,13080,3291,2641,19012,24.451,"77,76%","53,49%"
130140,Am-Eirunepe,202503,21396,3780,1953,27129,35.534,"76,35%","60,21%"
130150,Am-Envira,202503,11714,1949,889,14552,17.920,"81,21%","65,37%"
130160,Am-Fonte Boa,202503,18798,2024,1194,22016,27.875,"78,98%","67,44%"
130165,Am-Guajara,202503,10936,1959,713,13608,14.332,"94,95%","76,30%"
130170,Am-Humaita,202503,30283,5064,4955,40302,62.312,"64,68%","48,60%"
130180,Am-Ipixuna,202503,13301,1397,456,15154,25.458,"59,53%","52,25%"
130185,Am-Iranduba,202503,38918,5930,6780,51628,67.114,"76,93%","57,99%"
130190,Am-Itacoatiara,202503,47057,16323,10537,73917,112.520,"65,69%","41,82%"
130195,Am-Itamarati,202503,7949,1693,537,10179,11.730,"86,78%","67,77%"
130200,Am-Itapiranga,202503,4623,2537,1674,8834,10.805,"81,76%","42,79%"
130210,Am-Japura,202503,4559,2018,637,7214,9.397,"76,77%","48,52%"
130220,Am-Jurua,202503,7408,863,955,9226,11.152,"82,73%","66,43%"
130230,Am-Jutai,202503,19417,2227,1193,22837,27.656,"82,58%","70,21%"
130240,Am-Labrea,202503,30830,4672,5031,40533,48.927,"82,84%","63,01%"
130250,Am-Manacapuru,202503,59618,14737,8348,82703,110.691,"74,72%","53,86%"
130255,Am-Manaquiri,202503,11250,2477,2355,16082,17.009,"94,55%","66,14%"
130260,Am-Manaus,202503,701468,223381,194289,1119138,2.279.686,"49,09%","30,77%"
130270,Am-Manicore,202503,26780,6565,4542,37887,57.758,"65,60%","46,37%"
130280,Am-Maraa,202503,12331,1856,714,14901,15.843,"94,05%","77,83%"
130290,Am-Maues,202503,40964,5190,4130,50284,65.714,"76,52%","62,34%"
130300,Am-Nhamunda,202503,13069,2702,2062,17833,21.106,"84,49%","61,92%"
130310,Am-Nova Olinda do Norte,202503,17430,3815,2479,23724,28.267,"83,93%","61,66%"
130320,Am-Novo Airao,202503,7164,3523,1926,12613,16.467,"76,60%","43,51%"
130330,Am-Novo Aripuana,202503,11074,2581,1612,15267,24.987,"61,10%","44,32%"
130340,Am-Parintins,202503,60342,9990,7551,77883,101.956,"76,39%","59,18%"
130350,Am-Pauini,202503,11813,2287,779,14879,20.232,"73,54%","58,39%"
130353,Am-Presidente Figueiredo,202503,13832,4813,4408,23053,33.004,"69,85%","41,91%"
130356,Am-Rio Preto da Eva,202503,10277,4390,2399,17066,25.723,"66,35%","39,95%"
130360,Am-Santa Isabel do Rio Negro,202503,8598,1278,1161,11037,14.176,"77,86%","60,65%"
130370,Am-Santo Antonio do Ica,202503,16144,7162,2463,25769,30.448,"84,63%","53,02%"
130380,Am-Sao Gabriel da Cachoeira,202503,31999,7723,2092,41814,56.406,"74,13%","56,73%"
130390,Am-Sao Paulo de Olivenca,202503,25596,4588,2670,32854,35.196,"93,35%","72,72%"
130395,Am-Sao Sebastiao do Uatuma,202503,6211,1261,1243,8715,12.247,"71,16%","50,71%"
130400,Am-Silves,202503,7080,1506,1161,9747,12.404,"78,58%","57,08%"
130406,Am-Tabatinga,202503,33894,10000,4509,48403,72.283,"66,96%","46,89%"
130410,Am-Tapaua,202503,13415,2543,1578,17536,20.501,"85,54%","65,44%"
130420,Am-Tefe,202503,44214,8568,5339,58121,79.278,"73,31%","55,77%"
130423,Am-Tonantins,202503,12565,2037,1089,15691,20.224,"77,59%","62,13%"
130426,Am-Uarini,202503,10210,995,626,11831,15.278,"77,44%","66,83%"
130430,Am-Urucara,202503,9331,2193,1654,13178,19.505,"67,56%","47,84%"
130440,Am-Urucurituba,202503,13496,1329,1558,16383,25.592,"64,02%","52,74%"
140002,Rr-Amajari,202503,6317,1241,832,8390,15.583,"53,84%","40,54%"
140005,Rr-Alto Alegre,202503,7811,2268,1706,11785,23.049,"51,13%","33,89%"
140010,Rr-Boa Vista,202503,96560,70465,35435,202460,470.169,"43,06%","20,54%"
140015,Rr-Bonfim,202503,10967,1377,1859,14203,15.222,"93,31%","72,05%"
140017,Rr-Canta,202503,12894,2982,2531,18407,20.552,"89,56%","62,74%"
140020,Rr-Caracarai,202503,10293,3782,2056,16131,22.443,"71,88%","45,86%"
140023,Rr-Caroebe,202503,6353,1528,1388,9269,11.708,"79,17%","54,26%"
140028,Rr-Iracema,202503,3985,974,723,5682,10.778,"52,72%","36,97%"
140030,Rr-Mucajai,202503,12136,1974,1846,15956,19.619,"81,33%","61,86%"
140040,Rr-Normandia,202503,10393,2540,789,13722,15.744,"87,16%","66,01%"
140045,Rr-Pacaraima,202503,15313,3454,2390,21157,22.104,"95,72%","69,28%"
140047,Rr-Rorainopolis,202503,11426,4644,3144,19214,36.747,"52,29%","31,09%"
140050,Rr-Sao Joao da Baliza,202503,3881,1174,1020,6075,9.727,"62,46%","39,90%"
140060,Rr-Sao Luiz,202503,4291,1103,944,6338,7.777,"81,50%","55,18%"
140070,Rr-Uiramuta,202503,10368,2335,372,13075,15.571,"83,97%","66,59%"
150010,Pa-Abaetetuba,202503,93101,18155,17668,128924,170.999,"75,39%","54,45%"
150013,Pa-Abel Figueiredo,202503,3652,750,813,5215,6.302,"82,75%","57,95%"
150020,Pa-Acara,202503,37152,7507,4232,48891,62.701,"77,97%","59,25%"
150030,Pa-Afua,202503,31251,4562,2471,38284,40.246,"95,12%","77,65%"
150034,Pa-Agua Azul do Norte,202503,6531,1723,2145,10399,17.960,"57,90%","36,36%"
150040,Pa-Alenquer,202503,37137,5029,3899,46065,74.836,"61,55%","49,62%"
150050,Pa-Almeirim,202503,18294,4364,2835,25493,36.334,"70,16%","50,35%"
150060,Pa-Altamira,202503,39042,19536,15543,74121,136.982,"54,11%","28,50%"
150070,Pa-Anajas,202503,23892,4195,2896,30983,30.003,"103,27%","79,63%"
150080,Pa-Ananindeua,202503,115143,66259,50768,232170,507.838,"45,72%","22,67%"
150085,Pa-Anapu,202503,21199,3089,2792,27080,34.947,"77,49%","60,66%"
150090,Pa-Augusto Correa,202503,28279,6504,3508,38291,47.596,"80,45%","59,41%"
150095,Pa-Aurora do Para,202503,14395,2462,2353,19210,24.321,"78,99%","59,19%"
150100,Pa-Aveiro,202503,8804,1781,1497,12082,19.223,"62,85%","45,80%"
150110,Pa-Bagre,202503,17972,1932,692,20596,34.633,"59,47%","51,89%"
150120,Pa-Baiao,202503,20658,3508,2441,26607,55.949,"47,56%","36,92%"
150125,Pa-Bannach,202503,1628,570,513,2711,4.252,"63,76%","38,29%"
150130,Pa-Barcarena,202503,46101,19098,15521,80720,137.331,"58,78%","33,57%"
150140,Pa-Belem,202503,413964,131082,131174,676220,1.398.531,"48,35%","29,60%"
150145,Pa-Belterra,202503,7812,4438,2984,15234,18.954,"80,37%","41,22%"
150150,Pa-Benevides,202503,27488,12075,10254,49817,68.191,"73,06%","40,31%"
150157,Pa-Bom Jesus do Tocantins,202503,6102,2674,2172,10948,18.958,"57,75%","32,19%"
150160,Pa-Bonito,202503,7165,1911,1330,10406,12.998,"80,06%","55,12%"
150170,Pa-Braganca,202503,62550,16207,11039,89796,131.679,"68,19%","47,50%"
150172,Pa-Brasil Novo,202503,9559,2873,2749,15181,26.606,"57,06%","35,93%"
150175,Pa-Brejo Grande do Araguaia,202503,4026,977,1080,6083,6.985,"87,09%","57,64%"
150178,Pa-Breu Branco,202503,22763,4700,6053,33516,47.351,"70,78%","48,07%"
150180,Pa-Breves,202503,74828,9366,6627,90821,115.051,"78,94%","65,04%"
150190,Pa-Bujaru,202503,16361,4396,2445,23202,25.112,"92,39%","65,15%"
150195,Pa-Cachoeira do Piria,202503,12380,2527,1475,16382,19.578,"83,68%","63,23%"
150200,Pa-Cachoeira do Arari,202503,14714,2270,1402,18386,25.243,"72,84%","58,29%"
150210,Pa-Cameta,202503,87585,12805,7419,107809,143.837,"74,95%","60,89%"
150215,Pa-Canaa dos Carajas,202503,25160,12593,12165,49918,86.629,"57,62%","29,04%"
150220,Pa-Capanema,202503,26874,8537,6874,42285,74.808,"56,52%","35,92%"
150230,Pa-Capitao Poco,202503,32473,6178,5228,43879,59.960,"73,18%","54,16%"
150240,Pa-Castanhal,202503,50179,34880,22707,107766,207.603,"51,91%","24,17%"
150250,Pa-Chaves,202503,16166,1588,605,18359,21.487,"85,44%","75,24%"
150260,Pa-Colares,202503,7349,1652,1496,10497,13.526,"77,61%","54,33%"
150270,Pa-Conceicao do Araguaia,202503,9444,9439,8665,27548,47.099,"58,49%","20,05%"
150275,Pa-Concordia do Para,202503,18747,3541,2082,24370,28.287,"86,15%","66,27%"
150276,Pa-Cumaru do Norte,202503,4846,1666,1007,7519,14.937,"50,34%","32,44%"
150277,Pa-Curionopolis,202503,8362,3172,3371,14905,20.859,"71,46%","40,09%"
150280,Pa-Curralinho,202503,25888,3666,1626,31180,36.451,"85,54%","71,02%"
150285,Pa-Curua,202503,8733,2602,1501,12836,14.834,"86,53%","58,87%"
150290,Pa-Curuca,202503,24967,4246,3229,32442,44.413,"73,05%","56,22%"
150293,Pa-Dom Eliseu,202503,14901,5364,5477,25742,62.322,"41,30%","23,91%"
150295,Pa-Eldorado dos Carajas,202503,11854,4399,5496,21749,29.425,"73,91%","40,29%"
150300,Pa-Faro,202503,6136,980,1001,8117,9.125,"88,95%","67,24%"
150304,Pa-Floresta do Araguaia,202503,9006,2736,1970,13712,18.565,"73,86%","48,51%"
150307,Pa-Garrafao do Norte,202503,14196,3277,2158,19631,25.552,"76,83%","55,56%"
150309,Pa-Goianesia do Para,202503,10758,4924,4146,19828,27.059,"73,28%","39,76%"
150310,Pa-Gurupa,202503,25752,4182,1780,31714,33.922,"93,49%","75,92%"
150320,Pa-Igarape-Acu,202503,17424,5394,3638,26456,37.855,"69,89%","46,03%"
150330,Pa-Igarape-Miri,202503,40451,7671,4791,52913,68.955,"76,74%","58,66%"
150340,Pa-Inhangapi,202503,4834,1849,1262,7945,10.754,"73,88%","44,95%"
150345,Pa-Ipixuna do Para,202503,20449,3809,2862,27120,30.158,"89,93%","67,81%"
150350,Pa-Irituia,202503,19397,3067,2800,25264,32.698,"77,26%","59,32%"
150360,Pa-Itaituba,202503,48865,15486,13974,78325,133.684,"58,59%","36,55%"
150370,Pa-Itupiranga,202503,24669,5672,5357,35698,52.187,"68,40%","47,27%"
150375,Pa-Jacareacanga,202503,14655,2758,1326,18739,26.006,"72,06%","56,35%"
150380,Pa-Jacunda,202503,17054,4811,4907,26772,38.391,"69,74%","44,42%"
150390,Pa-Juruti,202503,25240,7517,3243,36000,53.952,"66,73%","46,78%"
150400,Pa-Limoeiro do Ajuru,202503,19468,3869,2161,25498,31.778,"80,24%","61,26%"
150405,Pa-Mae do Rio,202503,17515,3720,3127,24362,37.048,"65,76%","47,28%"
150410,Pa-Magalhaes Barata,202503,3955,1374,974,6303,8.428,"74,79%","46,93%"
150420,Pa-Maraba,202503,75349,36890,31867,144106,288.513,"49,95%","26,12%"
150430,Pa-Maracana,202503,18446,4164,2790,25400,27.207,"93,36%","67,80%"
150440,Pa-Marapanim,202503,15283,2431,2426,20140,28.105,"71,66%","54,38%"
150442,Pa-Marituba,202503,46801,15673,14754,77228,118.998,"64,90%","39,33%"
150445,Pa-Medicilandia,202503,18004,2575,2436,23015,28.633,"80,38%","62,88%"
150450,Pa-Melgaco,202503,21570,2011,1005,24586,29.846,"82,38%","72,27%"
150460,Pa-Mocajuba,202503,25994,2852,2284,31130,28.821,"108,01%","90,19%"
150470,Pa-Moju,202503,42666,10596,5613,58875,90.795,"64,84%","46,99%"
150475,Pa-Mojui dos Campos,202503,10925,4391,3363,18679,25.312,"73,80%","43,16%"
150480,Pa-Monte Alegre,202503,36458,7641,4442,48541,63.641,"76,27%","57,29%"
150490,Pa-Muana,202503,23242,5375,2811,31428,48.955,"64,20%","47,48%"
150495,Pa-Nova Esperanca do Piria,202503,14259,2238,1574,18071,21.259,"85,00%","67,07%"
150497,Pa-Nova Ipixuna,202503,5179,1749,1827,8755,14.417,"60,73%","35,92%"
150500,Pa-Nova Timboteua,202503,5798,1793,1492,9083,13.204,"68,79%","43,91%"
150503,Pa-Novo Progresso,202503,8933,5399,4469,18801,36.518,"51,48%","24,46%"
150506,Pa-Novo Repartimento,202503,32666,6284,5959,44909,63.754,"70,44%","51,24%"
150510,Pa-Obidos,202503,30426,6729,6014,43169,55.271,"78,10%","55,05%"
150520,Pa-Oeiras do Para,202503,27519,2852,1256,31627,36.377,"86,94%","75,65%"
150530,Pa-Oriximina,202503,35837,9609,5991,51437,72.460,"70,99%","49,46%"
150540,Pa-Ourem,202503,10276,2231,2013,14520,18.675,"77,75%","55,03%"
150543,Pa-Ourilandia do Norte,202503,12275,5743,4434,22452,34.905,"64,32%","35,17%"
150548,Pa-Pacaja,202503,25963,4908,4483,35354,43.594,"81,10%","59,56%"
150549,Pa-Palestina do Para,202503,3630,1065,861,5556,7.086,"78,41%","51,23%"
150550,Pa-Paragominas,202503,29064,19791,15455,64310,112.843,"56,99%","25,76%"
150553,Pa-Parauapebas,202503,56977,37336,35148,129461,298.854,"43,32%","19,07%"
150555,Pa-Pau D Arco,202503,4138,1111,1386,6635,7.296,"90,94%","56,72%"
150560,Pa-Peixe-Boi,202503,3727,1465,1001,6193,8.651,"71,59%","43,08%"
150563,Pa-Picarra,202503,4692,2176,2194,9062,13.341,"67,93%","35,17%"
150565,Pa-Placas,202503,11291,2913,2489,16693,18.772,"88,92%","60,15%"
150570,Pa-Ponta de Pedras,202503,18375,2774,2272,23421,25.767,"90,90%","71,31%"
150580,Pa-Portel,202503,37529,11113,4917,53559,66.898,"80,06%","56,10%"
150590,Pa-Porto de Moz,202503,22995,4600,2939,30534,43.673,"69,92%","52,65%"
150600,Pa-Prainha,202503,28262,3717,2695,34674,38.318,"90,49%","73,76%"
150610,Pa-Primavera,202503,6134,1525,1261,8920,11.332,"78,72%","54,13%"
150611,Pa-Quatipuru,202503,6265,1718,1360,9343,11.870,"78,71%","52,78%"
150613,Pa-Redencao,202503,20099,14022,11372,45493,91.947,"49,48%","21,86%"
150616,Pa-Rio Maria,202503,5941,2860,3233,12034,19.129,"62,91%","31,06%"
150618,Pa-Rondon do Para,202503,13135,4796,4267,22198,56.593,"39,22%","23,21%"
150619,Pa-Ruropolis,202503,12127,4313,3326,19766,37.360,"52,91%","32,46%"
150620,Pa-Salinopolis,202503,16472,8337,4747,29556,48.168,"61,36%","34,20%"
150630,Pa-Salvaterra,202503,14562,2151,1600,18313,25.441,"71,98%","57,24%"
150635,Pa-Santa Barbara do Para,202503,8278,3887,3142,15307,22.288,"68,68%","37,14%"
150640,Pa-Santa Cruz do Arari,202503,4658,1340,676,6674,7.654,"87,20%","60,86%"
150650,Pa-Santa Isabel do Para,202503,20470,10118,6297,36885,78.317,"47,10%","26,14%"
150655,Pa-Santa Luzia do Para,202503,12539,2589,1744,16872,21.217,"79,52%","59,10%"
150658,Pa-Santa Maria das Barreiras,202503,6426,3943,3813,14182,17.079,"83,04%","37,63%"
150660,Pa-Santa Maria do Para,202503,11162,4374,2902,18438,25.696,"71,75%","43,44%"
150670,Pa-Santana do Araguaia,202503,15062,4266,5107,24435,31.683,"77,12%","47,54%"
150680,Pa-Santarem,202503,143857,57150,47323,248330,357.311,"69,50%","40,26%"
150690,Pa-Santarem Novo,202503,4425,903,864,6192,6.348,"97,54%","69,71%"
150700,Pa-Santo Antonio do Taua,202503,14895,4571,3406,22872,29.134,"78,51%","51,13%"
150710,Pa-Sao Caetano de Odivelas,202503,7899,3145,1883,12927,17.248,"74,95%","45,80%"
150715,Pa-Sao Domingos do Araguaia,202503,10177,2442,2572,15191,21.638,"70,21%","47,03%"
150720,Pa-Sao Domingos do Capim,202503,19373,3409,2357,25139,32.449,"77,47%","59,70%"
150730,Pa-Sao Felix do Xingu,202503,30181,7830,6899,44910,65.957,"68,09%","45,76%"
150740,Pa-Sao Francisco do Para,202503,8381,2513,2013,12907,15.418,"83,71%","54,36%"
150745,Pa-Sao Geraldo do Araguaia,202503,10639,3426,3392,17457,24.978,"69,89%","42,59%"
150746,Pa-Sao Joao da Ponta,202503,3543,844,769,5156,4.509,"114,35%","78,58%"
150747,Pa-Sao Joao de Pirabas,202503,11532,2537,2524,16593,21.447,"77,37%","53,77%"
150750,Pa-Sao Joao do Araguaia,202503,7943,2116,2109,12168,14.246,"85,41%","55,76%"
150760,Pa-Sao Miguel do Guama,202503,24295,8445,4486,37226,55.798,"66,72%","43,54%"
150770,Pa-Sao Sebastiao da Boa Vista,202503,22337,2735,1434,26506,27.441,"96,59%","81,40%"
150775,Pa-Sapucaia,202503,2450,715,685,3850,6.160,"62,50%","39,77%"
150780,Pa-Senador Jose Porfirio,202503,13829,1878,1419,17126,24.441,"70,07%","56,58%"
150790,Pa-Soure,202503,14225,2856,2024,19105,25.218,"75,76%","56,41%"
150795,Pa-Tailandia,202503,35197,12650,7172,55019,75.526,"72,85%","46,60%"
150796,Pa-Terra Alta,202503,7217,1228,1307,9752,10.815,"90,17%","66,73%"
150797,Pa-Terra Santa,202503,10727,1953,2248,14928,19.667,"75,90%","54,54%"
150800,Pa-Tome-Acu,202503,32845,11372,7166,51383,72.326,"71,04%","45,41%"
150803,Pa-Tracuateua,202503,19219,3206,2777,25202,30.373,"82,98%","63,28%"
150805,Pa-Trairao,202503,7721,2785,1991,12497,15.619,"80,01%","49,43%"
150808,Pa-Tucuma,202503,6654,10379,6946,23979,42.480,"56,45%","15,66%"
150810,Pa-Tucurui,202503,28919,14350,12902,56171,96.238,"58,37%","30,05%"
150812,Pa-Ulianopolis,202503,11477,3913,3064,18454,39.576,"46,63%","29,00%"
150815,Pa-Uruara,202503,21624,5937,3632,31193,45.939,"67,90%","47,07%"
150820,Pa-Vigia,202503,27091,4974,4813,36878,53.806,"68,54%","50,35%"
150830,Pa-Viseu,202503,36914,5026,2858,44798,61.970,"72,29%","59,57%"
150835,Pa-Vitoria do Xingu,202503,8219,2910,1713,12842,16.414,"78,24%","50,07%"
150840,Pa-Xinguara,202503,14654,6916,5770,27340,56.999,"47,97%","25,71%"
160005,Ap-Serra do Navio,202503,2424,566,494,3484,4.986,"69,88%","48,62%"
160010,Ap-Amapa,202503,5147,1017,570,6734,8.434,"79,84%","61,03%"
160015,Ap-Pedra Branca do Amapari,202503,7841,966,1049,9856,13.798,"71,43%","56,83%"
160020,Ap-Calcoene,202503,6315,1108,890,8313,11.391,"72,98%","55,44%"
160021,Ap-Cutias,202503,3566,1091,455,5112,4.725,"108,19%","75,47%"
160023,Ap-Ferreira Gomes,202503,3362,1293,661,5316,7.145,"74,40%","47,05%"
160025,Ap-Itaubal,202503,6209,441,541,7191,6.043,"119,00%","102,75%"
160027,Ap-Laranjal do Jari,202503,18695,4537,4126,27358,37.969,"72,05%","49,24%"
160030,Ap-Macapa,202503,169516,55222,40623,265361,487.200,"54,47%","34,79%"
160040,Ap-Mazagao,202503,17071,3330,2280,22681,23.575,"96,21%","72,41%"
160050,Ap-Oiapoque,202503,16791,3225,2633,22649,30.481,"74,31%","55,09%"
160053,Ap-Porto Grande,202503,10556,2457,2125,15138,18.988,"79,72%","55,59%"
160055,Ap-Pracuuba,202503,3622,311,370,4303,4.042,"106,46%","89,61%"
160060,Ap-Santana,202503,50430,14920,11522,76872,118.353,"64,95%","42,61%"
160070,Ap-Tartarugalzinho,202503,9307,1760,1722,12789,13.785,"92,77%","67,52%"
160080,Ap-Vitoria do Jari,202503,8164,873,857,9894,11.922,"82,99%","68,48%"
170025,To-Abreulandia,202503,571,600,844,2015,2.668,"75,52%","21,40%"
170030,To-Aguiarnopolis,202503,1201,1199,1081,3481,4.537,"76,72%","26,47%"
170035,To-Alianca do Tocantins,202503,1599,954,1138,3691,5.222,"70,68%","30,62%"
170040,To-Almas,202503,2545,1463,1463,5471,6.542,"83,63%","38,90%"
170070,To-Alvorada,202503,2478,1254,1570,5302,9.094,"58,30%","27,25%"
170100,To-Ananas,202503,4016,1584,1703,7303,10.662,"68,50%","37,67%"
170105,To-Angico,202503,525,753,756,2034,2.918,"69,71%","17,99%"
170110,To-Aparecida do Rio Negro,202503,1442,1096,903,3441,5.067,"67,91%","28,46%"
170130,To-Aragominas,202503,1959,932,1275,4166,5.360,"77,72%","36,55%"
170190,To-Araguacema,202503,1982,1231,1097,4310,6.039,"71,37%","32,82%"
170200,To-Araguacu,202503,1500,1335,1737,4572,8.273,"55,26%","18,13%"
170210,To-Araguaina,202503,25366,31966,25327,82659,181.493,"45,54%","13,98%"
170215,To-Araguana,202503,1592,895,784,3271,4.338,"75,40%","36,70%"
170220,To-Araguatins,202503,9416,6073,3964,19453,33.205,"58,58%","28,36%"
170230,To-Arapoema,202503,1766,1007,1110,3883,5.553,"69,93%","31,80%"
170240,To-Arraias,202503,4448,1673,2258,8379,10.522,"79,63%","42,27%"
170255,To-Augustinopolis,202503,5395,3047,2675,11117,18.128,"61,33%","29,76%"
170270,To-Aurora do Tocantins,202503,1140,526,626,2292,3.420,"67,02%","33,33%"
170290,To-Axixa do Tocantins,202503,6184,1544,1380,9108,10.663,"85,42%","57,99%"
170300,To-Babaculandia,202503,3013,1185,1270,5468,7.779,"70,29%","38,73%"
170305,To-Bandeirantes do Tocantins,202503,925,524,705,2154,3.534,"60,95%","26,17%"
170307,To-Barra do Ouro,202503,1839,1181,759,3779,4.641,"81,43%","39,63%"
170310,To-Barrolandia,202503,1710,1094,1291,4095,4.915,"83,32%","34,79%"
170320,To-Bernardo Sayao,202503,1251,787,877,2915,4.316,"67,54%","28,99%"
170330,To-Bom Jesus do Tocantins,202503,2176,780,592,3548,4.181,"84,86%","52,04%"
170360,To-Brasilandia do Tocantins,202503,691,480,515,1686,2.016,"83,63%","34,28%"
170370,To-Brejinho de Nazare,202503,1704,829,986,3519,4.796,"73,37%","35,53%"
170380,To-Buriti do Tocantins,202503,2729,1529,1306,5564,10.654,"52,22%","25,61%"
170382,To-Cachoeirinha,202503,790,442,488,1720,1.991,"86,39%","39,68%"
170384,To-Campos Lindos,202503,2793,1912,1362,6067,8.951,"67,78%","31,20%"
170386,To-Cariri do Tocantins,202503,700,773,1222,2695,4.147,"64,99%","16,88%"
170388,To-Carmolandia,202503,933,537,534,2004,2.246,"89,23%","41,54%"
170389,To-Carrasco Bonito,202503,1450,767,602,2819,3.362,"83,85%","43,13%"
170390,To-Caseara,202503,2092,834,980,3906,5.009,"77,98%","41,76%"
170410,To-Centenario,202503,739,356,499,1594,2.135,"74,66%","34,61%"
170460,To-Chapada de Areia,202503,566,315,445,1326,1.563,"84,84%","36,21%"
170510,To-Chapada da Natividade,202503,1184,651,742,2577,3.182,"80,99%","37,21%"
170550,To-Colinas do Tocantins,202503,8987,5569,5109,19665,35.957,"54,69%","24,99%"
170555,To-Combinado,202503,1645,1078,941,3664,4.896,"74,84%","33,60%"
170560,To-Conceicao do Tocantins,202503,1350,840,687,2877,3.956,"72,72%","34,13%"
170600,To-Couto de Magalhaes,202503,2109,1082,1214,4405,5.515,"79,87%","38,24%"
170610,To-Cristalandia,202503,2158,903,1312,4373,6.437,"67,94%","33,52%"
170625,To-Crixas do Tocantins,202503,428,425,508,1361,1.499,"90,79%","28,55%"
170650,To-Darcinopolis,202503,2543,1097,869,4509,6.054,"74,48%","42,01%"
170700,To-Dianopolis,202503,3904,3542,3178,10624,18.031,"58,92%","21,65%"
170710,To-Divinopolis do Tocantins,202503,2302,964,1242,4508,7.297,"61,78%","31,55%"
170720,To-Dois Irmaos do Tocantins,202503,2411,1093,1316,4820,6.395,"75,37%","37,70%"
170730,To-Duere,202503,1430,722,739,2891,4.321,"66,91%","33,09%"
170740,To-Esperantina,202503,4189,1302,1378,6869,7.493,"91,67%","55,91%"
170755,To-Fatima,202503,986,665,667,2318,3.520,"65,85%","28,01%"
170765,To-Figueiropolis,202503,1285,791,897,2973,5.336,"55,72%","24,08%"
170770,To-Filadelfia,202503,3215,1138,1108,5461,7.823,"69,81%","41,10%"
170820,To-Formoso do Araguaia,202503,5423,3316,3278,12017,19.428,"61,85%","27,91%"
170825,To-Fortaleza do Tabocao,202503,1467,624,840,2931,3.676,"79,73%","39,91%"
170830,To-Goianorte,202503,1585,1020,1063,3668,4.840,"75,79%","32,75%"
170900,To-Goiatins,202503,6640,1953,1566,10159,12.816,"79,27%","51,81%"
170930,To-Guarai,202503,4972,3726,3744,12442,25.681,"48,45%","19,36%"
170950,To-Gurupi,202503,9023,13516,13270,35809,89.574,"39,98%","10,07%"
170980,To-Ipueiras,202503,451,440,462,1353,1.627,"83,16%","27,72%"
171050,To-Itacaja,202503,3570,946,921,5437,6.969,"78,02%","51,23%"
171070,To-Itaguatins,202503,2509,801,781,4091,5.206,"78,58%","48,19%"
171090,To-Itapiratins,202503,1178,826,638,2642,3.679,"71,81%","32,02%"
171110,To-Itapora do Tocantins,202503,675,420,551,1646,2.464,"66,80%","27,39%"
171150,To-Jau do Tocantins,202503,704,656,957,2317,3.403,"68,09%","20,69%"
171180,To-Juarina,202503,685,672,799,2156,2.305,"93,54%","29,72%"
171190,To-Lagoa da Confusao,202503,4346,1722,1175,7243,16.312,"44,40%","26,64%"
171195,To-Lagoa do Tocantins,202503,1257,692,691,2640,3.610,"73,13%","34,82%"
171200,To-Lajeado,202503,588,677,602,1867,3.520,"53,04%","16,70%"
171215,To-Lavandeira,202503,587,385,308,1280,1.673,"76,51%","35,09%"
171240,To-Lizarda,202503,1363,532,643,2538,2.991,"84,85%","45,57%"
171245,To-Luzinopolis,202503,799,813,695,2307,2.803,"82,30%","28,51%"
171250,To-Marianopolis do Tocantins,202503,944,832,1007,2783,4.772,"58,32%","19,78%"
171270,To-Mateiros,202503,810,595,434,1839,2.888,"63,68%","28,05%"
171280,To-Maurilandia do Tocantins,202503,1340,753,576,2669,3.171,"84,17%","42,26%"
171320,To-Miracema do Tocantins,202503,3615,3704,3690,11009,18.787,"58,60%","19,24%"
171330,To-Miranorte,202503,3735,2200,2663,8598,13.056,"65,85%","28,61%"
171360,To-Monte do Carmo,202503,2257,1033,1276,4566,5.722,"79,80%","39,44%"
171370,To-Monte Santo do Tocantins,202503,771,570,555,1896,2.500,"75,84%","30,84%"
171380,To-Palmeiras do Tocantins,202503,1996,1045,939,3980,4.897,"81,27%","40,76%"
171395,To-Muricilandia,202503,1332,612,779,2723,3.485,"78,13%","38,22%"
171420,To-Natividade,202503,2672,1535,1587,5794,8.961,"64,66%","29,82%"
171430,To-Nazare,202503,1507,1001,899,3407,4.660,"73,11%","32,34%"
171488,To-Nova Olinda,202503,3477,2059,1893,7429,10.609,"70,03%","32,77%"
171500,To-Nova Rosalandia,202503,794,631,930,2355,3.403,"69,20%","23,33%"
171510,To-Novo Acordo,202503,1704,680,615,2999,4.102,"73,11%","41,54%"
171515,To-Novo Alegre,202503,561,330,386,1277,1.841,"69,36%","30,47%"
171525,To-Novo Jardim,202503,1096,422,469,1987,2.263,"87,80%","48,43%"
171550,To-Oliveira de Fatima,202503,328,388,275,991,1.211,"81,83%","27,09%"
171570,To-Palmeirante,202503,1647,1143,960,3750,4.909,"76,39%","33,55%"
171575,To-Palmeiropolis,202503,1872,1115,1266,4253,7.119,"59,74%","26,30%"
171610,To-Paraiso do Tocantins,202503,4011,8422,5660,18093,55.164,"32,80%","7,27%"
171620,To-Parana,202503,4975,1560,1583,8118,10.854,"74,79%","45,84%"
171630,To-Pau D Arco,202503,1479,752,886,3117,4.085,"76,30%","36,21%"
171650,To-Pedro Afonso,202503,2868,2598,2387,7853,14.731,"53,31%","19,47%"
171660,To-Peixe,202503,2920,1292,1921,6133,9.438,"64,98%","30,94%"
171665,To-Pequizeiro,202503,1448,1186,1036,3670,5.038,"72,85%","28,74%"
171670,To-Colmeia,202503,2509,1338,1518,5365,9.158,"58,58%","27,40%"
171700,To-Pindorama do Tocantins,202503,1554,862,926,3342,4.596,"72,72%","33,81%"
171720,To-Piraque,202503,928,454,603,1985,2.265,"87,64%","40,97%"
171750,To-Pium,202503,1534,1561,1226,4321,7.375,"58,59%","20,80%"
171780,To-Ponte Alta do Bom Jesus,202503,1415,843,1023,3281,4.295,"76,39%","32,95%"
171790,To-Ponte Alta do Tocantins,202503,2071,1336,1058,4465,7.842,"56,94%","26,41%"
171800,To-Porto Alegre do Tocantins,202503,965,446,624,2035,2.953,"68,91%","32,68%"
171820,To-Porto Nacional,202503,11310,13123,10261,34694,68.555,"50,61%","16,50%"
171830,To-Praia Norte,202503,2839,1303,990,5132,9.460,"54,25%","30,01%"
171840,To-Presidente Kennedy,202503,755,596,728,2079,3.051,"68,14%","24,75%"
171845,To-Pugmil,202503,849,408,538,1795,2.231,"80,46%","38,05%"
171850,To-Recursolandia,202503,2300,452,490,3242,3.471,"93,40%","66,26%"
171855,To-Riachinho,202503,1325,1000,873,3198,4.039,"79,18%","32,81%"
171865,To-Rio da Conceicao,202503,680,455,435,1570,1.822,"86,17%","37,32%"
171870,To-Rio dos Bois,202503,961,630,710,2301,2.833,"81,22%","33,92%"
171875,To-Rio Sono,202503,2452,954,793,4199,4.798,"87,52%","51,10%"
171880,To-Sampaio,202503,2696,783,775,4254,4.372,"97,30%","61,67%"
171884,To-Sandolandia,202503,1682,631,828,3141,3.873,"81,10%","43,43%"
171886,To-Santa Fe do Araguaia,202503,1658,1446,1149,4253,7.489,"56,79%","22,14%"
171888,To-Santa Maria do Tocantins,202503,680,494,538,1712,2.726,"62,80%","24,94%"
171889,To-Santa Rita do Tocantins,202503,459,420,548,1427,2.291,"62,29%","20,03%"
171890,To-Santa Rosa do Tocantins,202503,1670,1012,1172,3854,4.789,"80,48%","34,87%"
171900,To-Santa Tereza do Tocantins,202503,950,604,559,2113,2.889,"73,14%","32,88%"
172000,To-Santa Terezinha do Tocantins,202503,533,727,519,1779,2.463,"72,23%","21,64%"
172010,To-Sao Bento do Tocantins,202503,2660,999,1057,4716,5.936,"79,45%","44,81%"
172015,To-Sao Felix do Tocantins,202503,514,528,331,1373,1.875,"73,23%","27,41%"
172020,To-Sao Miguel do Tocantins,202503,5139,2310,1473,8922,13.939,"64,01%","36,87%"
172025,To-Sao Salvador do Tocantins,202503,906,509,679,2094,2.385,"87,80%","37,99%"
172030,To-Sao Sebastiao do Tocantins,202503,1824,1086,969,3879,4.189,"92,60%","43,54%"
172049,To-Sao Valerio da Natividade,202503,1600,771,880,3251,4.547,"71,50%","35,19%"
172065,To-Silvanopolis,202503,1782,1151,988,3921,5.252,"74,66%","33,93%"
172080,To-Sitio Novo do Tocantins,202503,3678,1713,1598,6989,11.334,"61,66%","32,45%"
172085,To-Sucupira,202503,282,411,568,1261,1.599,"78,86%","17,64%"
172090,To-Taguatinga,202503,6354,1810,2221,10385,14.247,"72,89%","44,60%"
172093,To-Taipas do Tocantins,202503,572,475,373,1420,2.086,"68,07%","27,42%"
172097,To-Talisma,202503,521,497,710,1728,2.509,"68,87%","20,77%"
172100,To-Palmas,202503,56666,40915,44370,141951,323.625,"43,86%","17,51%"
172110,To-Tocantinia,202503,3986,1521,912,6419,7.751,"82,82%","51,43%"
172120,To-Tocantinopolis,202503,7305,4604,3731,15640,23.203,"67,41%","31,48%"
172125,To-Tupirama,202503,422,376,416,1214,2.003,"60,61%","21,07%"
172130,To-Tupiratins,202503,381,511,455,1347,1.897,"71,01%","20,08%"
172208,To-Wanderlandia,202503,3476,1441,1648,6565,10.751,"61,06%","32,33%"
172210,To-Xambioa,202503,4180,1143,1624,6947,10.683,"65,03%","39,13%"
210005,Ma-Acailandia,202503,28262,16227,16432,60921,110.506,"55,13%","25,58%"
210010,Ma-Afonso Cunha,202503,5462,647,363,6472,6.296,"102,80%","86,75%"
210015,Ma-Agua Doce do Maranhao,202503,7149,1561,1091,9801,12.446,"78,75%","57,44%"
210020,Ma-Alcantara,202503,12819,1988,2374,17181,18.774,"91,51%","68,28%"
210030,Ma-Aldeias Altas,202503,11161,3285,1491,15937,23.782,"67,01%","46,93%"
210040,Ma-Altamira do Maranhao,202503,4193,426,554,5173,6.565,"78,80%","63,87%"
210043,Ma-Alto Alegre do Maranhao,202503,11199,3274,2079,16552,24.543,"67,44%","45,63%"
210047,Ma-Alto Alegre do Pindare,202503,14459,3903,3177,21539,26.411,"81,55%","54,75%"
210050,Ma-Alto Parnaiba,202503,4985,1496,1339,7820,11.382,"68,70%","43,80%"
210055,Ma-Amapa do Maranhao,202503,4648,951,841,6440,7.364,"87,45%","63,12%"
210060,Ma-Amarante do Maranhao,202503,20170,5536,2645,28351,38.333,"73,96%","52,62%"
210070,Ma-Anajatuba,202503,14660,1965,1365,17990,26.221,"68,61%","55,91%"
210080,Ma-Anapurus,202503,11489,1578,724,13791,14.111,"97,73%","81,42%"
210083,Ma-Apicum-Acu,202503,12502,1381,1295,15178,17.984,"84,40%","69,52%"
210087,Ma-Araguana,202503,5800,1037,661,7498,11.347,"66,08%","51,11%"
210090,Ma-Araioses,202503,21877,4322,2479,28678,40.278,"71,20%","54,32%"
210095,Ma-Arame,202503,16086,4091,1840,22017,26.191,"84,06%","61,42%"
210100,Ma-Arari,202503,12769,3956,2994,19719,30.521,"64,61%","41,84%"
210110,Ma-Axixa,202503,7143,960,651,8754,12.079,"72,47%","59,14%"
210120,Ma-Bacabal,202503,46110,12496,11425,70031,107.620,"65,07%","42,85%"
210125,Ma-Bacabeira,202503,9031,2080,1544,12655,17.414,"72,67%","51,86%"
210130,Ma-Bacuri,202503,8175,1237,1382,10794,16.610,"64,98%","49,22%"
210135,Ma-Bacurituba,202503,3285,441,780,4506,5.374,"83,85%","61,13%"
210140,Ma-Balsas,202503,30829,17429,14603,62861,106.094,"59,25%","29,06%"
210150,Ma-Barao de Grajau,202503,8285,1805,1606,11696,19.458,"60,11%","42,58%"
210160,Ma-Barra do Corda,202503,38193,10995,9639,58827,87.672,"67,10%","43,56%"
210170,Ma-Barreirinhas,202503,37758,10109,5195,53062,67.999,"78,03%","55,53%"
210173,Ma-Belagua,202503,7089,981,453,8523,8.716,"97,79%","81,33%"
210177,Ma-Bela Vista do Maranhao,202503,6849,1262,954,9065,12.073,"75,08%","56,73%"
210180,Ma-Benedito Leite,202503,3061,492,462,4015,5.597,"71,73%","54,69%"
210190,Ma-Bequimao,202503,10230,2261,2181,14672,19.983,"73,42%","51,19%"
210193,Ma-Bernardo do Mearim,202503,2483,807,556,3846,5.983,"64,28%","41,50%"
210197,Ma-Boa Vista do Gurupi,202503,4876,941,571,6388,7.769,"82,22%","62,76%"
210200,Ma-Bom Jardim,202503,18043,4490,2600,25133,34.035,"73,84%","53,01%"
210203,Ma-Bom Jesus das Selvas,202503,13913,4169,2713,20795,29.588,"70,28%","47,02%"
210207,Ma-Bom Lugar,202503,6446,1537,1213,9196,12.414,"74,08%","51,93%"
210210,Ma-Brejo,202503,18081,3830,1961,23872,35.322,"67,58%","51,19%"
210215,Ma-Brejo de Areia,202503,6342,876,697,7915,9.387,"84,32%","67,56%"
210220,Ma-Buriti,202503,19277,2992,1207,23476,30.799,"76,22%","62,59%"
210230,Ma-Buriti Bravo,202503,13961,1547,1961,17469,22.940,"76,15%","60,86%"
210232,Ma-Buriticupu,202503,25227,7351,5442,38020,56.896,"66,82%","44,34%"
210235,Ma-Buritirana,202503,6861,1695,1326,9882,13.157,"75,11%","52,15%"
210237,Ma-Cachoeira Grande,202503,8729,757,1208,10694,10.004,"106,90%","87,26%"
210240,Ma-Cajapio,202503,5817,1120,919,7856,10.342,"75,96%","56,25%"
210250,Ma-Cajari,202503,14181,1793,1346,17320,16.711,"103,64%","84,86%"
210255,Ma-Campestre do Maranhao,202503,4477,2157,1798,8432,12.553,"67,17%","35,66%"
210260,Ma-Candido Mendes,202503,12261,2194,1783,16238,20.413,"79,55%","60,06%"
210270,Ma-Cantanhede,202503,9048,2206,1488,12742,24.976,"51,02%","36,23%"
210275,Ma-Capinzal do Norte,202503,5960,1288,925,8173,11.664,"70,07%","51,10%"
210280,Ma-Carolina,202503,9876,3073,2613,15562,24.606,"63,24%","40,14%"
210290,Ma-Carutapera,202503,17075,1763,1773,20611,24.855,"82,92%","68,70%"
210300,Ma-Caxias,202503,43783,29021,14827,87631,163.428,"53,62%","26,79%"
210310,Ma-Cedral,202503,6135,770,870,7775,10.444,"74,44%","58,74%"
210312,Ma-Central do Maranhao,202503,5938,511,717,7166,7.233,"99,07%","82,10%"
210315,Ma-Centro do Guilherme,202503,8431,640,614,9685,12.668,"76,45%","66,55%"
210317,Ma-Centro Novo do Maranhao,202503,11160,1589,789,13538,16.529,"81,90%","67,52%"
210320,Ma-Chapadinha,202503,51625,6104,4671,62400,84.202,"74,11%","61,31%"
210325,Ma-Cidelandia,202503,7499,1496,1547,10542,13.152,"80,16%","57,02%"
210330,Ma-Codo,202503,52922,11168,11011,75101,118.295,"63,49%","44,74%"
210340,Ma-Coelho Neto,202503,23001,4648,3191,30840,42.918,"71,86%","53,59%"
210350,Ma-Colinas,202503,20687,3391,2554,26632,41.745,"63,80%","49,56%"
210355,Ma-Conceicao do Lago-Acu,202503,8904,2013,1152,12069,15.264,"79,07%","58,33%"
210360,Ma-Coroata,202503,26789,9949,5875,42613,61.351,"69,46%","43,67%"
210370,Ma-Cururupu,202503,19861,1940,4295,26096,32.608,"80,03%","60,91%"
210375,Ma-Davinopolis,202503,4360,2797,2340,9497,14.788,"64,22%","29,48%"
210380,Ma-Dom Pedro,202503,10747,2189,1817,14753,23.579,"62,57%","45,58%"
210390,Ma-Duque Bacelar,202503,8373,885,571,9829,10.448,"94,08%","80,14%"
210400,Ma-Esperantinopolis,202503,9785,2129,1442,13356,18.725,"71,33%","52,26%"
210405,Ma-Estreito,202503,10935,5429,3580,19944,34.353,"58,06%","31,83%"
210407,Ma-Feira Nova do Maranhao,202503,4209,1370,1002,6581,8.236,"79,91%","51,10%"
210408,Ma-Fernando Falcao,202503,8311,1538,657,10506,11.184,"93,94%","74,31%"
210409,Ma-Formosa da Serra Negra,202503,9482,2711,1529,13722,18.133,"75,67%","52,29%"
210410,Ma-Fortaleza dos Nogueiras,202503,6875,1880,2015,10770,12.951,"83,16%","53,08%"
210420,Ma-Fortuna,202503,9556,1860,1473,12889,17.346,"74,31%","55,09%"
210430,Ma-Godofredo Viana,202503,5392,805,755,6952,10.422,"66,71%","51,74%"
210440,Ma-Goncalves Dias,202503,9225,1314,1223,11762,17.579,"66,91%","52,48%"
210450,Ma-Governador Archer,202503,4821,1104,784,6709,10.472,"64,07%","46,04%"
210455,Ma-Governador Edison Lobao,202503,6601,3632,2551,12784,18.908,"67,61%","34,91%"
210460,Ma-Governador Eugenio Barros,202503,6487,1920,1243,9650,14.258,"67,68%","45,50%"
210462,Ma-Governador Luiz Rocha,202503,3576,953,819,5348,7.219,"74,08%","49,54%"
210465,Ma-Governador Newton Bello,202503,6017,1053,767,7837,10.981,"71,37%","54,79%"
210467,Ma-Governador Nunes Freire,202503,12666,2978,1979,17623,23.563,"74,79%","53,75%"
210470,Ma-Graca Aranha,202503,3351,887,954,5192,6.161,"84,27%","54,39%"
210480,Ma-Grajau,202503,37800,9640,6126,53566,76.578,"69,95%","49,36%"
210490,Ma-Guimaraes,202503,5646,1177,1257,8080,10.470,"77,17%","53,93%"
210500,Ma-Humberto de Campos,202503,18708,4053,1667,24428,26.546,"92,02%","70,47%"
210510,Ma-Icatu,202503,16965,2459,1535,20959,25.332,"82,74%","66,97%"
210515,Ma-Igarape do Meio,202503,8092,1775,1247,11114,14.350,"77,45%","56,39%"
210520,Ma-Igarape Grande,202503,5277,1730,996,8003,10.463,"76,49%","50,43%"
210530,Ma-Imperatriz,202503,73266,34651,34077,141994,285.146,"49,80%","25,69%"
210535,Ma-Itaipava do Grajau,202503,9852,1298,979,12129,14.143,"85,76%","69,66%"
210540,Ma-Itapecuru Mirim,202503,26735,10737,7039,44511,62.269,"71,48%","42,93%"
210542,Ma-Itinga do Maranhao,202503,11066,2301,3133,16500,22.934,"71,95%","48,25%"
210545,Ma-Jatoba,202503,4944,1091,800,6835,7.610,"89,82%","64,97%"
210547,Ma-Jenipapo dos Vieiras,202503,10472,2051,1206,13729,17.499,"78,46%","59,84%"
210550,Ma-Joao Lisboa,202503,10813,4286,3285,18384,25.287,"72,70%","42,76%"
210560,Ma-Joselandia,202503,8443,2292,1368,12103,15.235,"79,44%","55,42%"
210565,Ma-Junco do Maranhao,202503,2782,901,678,4361,5.275,"82,67%","52,74%"
210570,Ma-Lago da Pedra,202503,24007,4058,2951,31016,45.875,"67,61%","52,33%"
210580,Ma-Lago do Junco,202503,5245,952,1173,7370,9.700,"75,98%","54,07%"
210590,Ma-Lago Verde,202503,8510,2146,1444,12100,15.077,"80,25%","56,44%"
210592,Ma-Lagoa do Mato,202503,6243,954,611,7808,10.809,"72,24%","57,76%"
210594,Ma-Lago dos Rodrigues,202503,4587,1309,1122,7018,8.961,"78,32%","51,19%"
210596,Ma-Lagoa Grande do Maranhao,202503,7860,1635,1249,10744,11.710,"91,75%","67,12%"
210598,Ma-Lajeado Novo,202503,4342,678,518,5538,7.227,"76,63%","60,08%"
210600,Ma-Lima Campos,202503,5292,2113,1561,8966,11.558,"77,57%","45,79%"
210610,Ma-Loreto,202503,5432,1688,1269,8389,11.876,"70,64%","45,74%"
210620,Ma-Luis Domingues,202503,5713,738,908,7359,7.351,"100,11%","77,72%"
210630,Ma-Magalhaes de Almeida,202503,6831,2148,1213,10192,14.001,"72,79%","48,79%"
210632,Ma-Maracacume,202503,12560,2035,1538,16133,21.686,"74,39%","57,92%"
210635,Ma-Maraja do Sena,202503,4789,738,393,5920,7.165,"82,62%","66,84%"
210637,Ma-Maranhaozinho,202503,7087,1112,1186,9385,14.086,"66,63%","50,31%"
210640,Ma-Mata Roma,202503,11670,1980,837,14487,17.537,"82,61%","66,55%"
210650,Ma-Matinha,202503,15426,2498,1693,19617,22.530,"87,07%","68,47%"
210660,Ma-Matoes,202503,17563,3349,2441,23353,33.300,"70,13%","52,74%"
210663,Ma-Matoes do Norte,202503,5489,1169,941,7599,17.945,"42,35%","30,59%"
210667,Ma-Milagres do Maranhao,202503,4722,924,552,6198,9.048,"68,50%","52,19%"
210670,Ma-Mirador,202503,13516,2174,1710,17400,21.518,"80,86%","62,81%"
210675,Ma-Miranda do Norte,202503,10365,2002,1905,14272,24.377,"58,55%","42,52%"
210680,Ma-Mirinzal,202503,9499,825,1209,11533,14.297,"80,67%","66,44%"
210690,Ma-Moncao,202503,17528,2754,2598,22880,28.606,"79,98%","61,27%"
210700,Ma-Montes Altos,202503,5037,1338,1236,7611,9.309,"81,76%","54,11%"
210710,Ma-Morros,202503,12483,2098,1190,15771,18.994,"83,03%","65,72%"
210720,Ma-Nina Rodrigues,202503,7702,1244,918,9864,14.551,"67,79%","52,93%"
210725,Ma-Nova Colinas,202503,2431,861,763,4055,5.144,"78,83%","47,26%"
210730,Ma-Nova Iorque,202503,2632,372,501,3505,4.412,"79,44%","59,66%"
210735,Ma-Nova Olinda do Maranhao,202503,9605,1523,1386,12514,14.468,"86,49%","66,39%"
210740,Ma-Olho D Agua das Cunhas,202503,9843,2011,1649,13503,18.295,"73,81%","53,80%"
210745,Ma-Olinda Nova do Maranhao,202503,8477,1474,1156,11107,13.909,"79,85%","60,95%"
210750,Ma-Paco do Lumiar,202503,44263,19747,12668,76678,152.306,"50,34%","29,06%"
210760,Ma-Palmeirandia,202503,13524,1204,1461,16189,21.606,"74,93%","62,59%"
210770,Ma-Paraibano,202503,11257,1842,1853,14952,18.619,"80,31%","60,46%"
210780,Ma-Parnarama,202503,14935,4717,3840,23492,32.256,"72,83%","46,30%"
210790,Ma-Passagem Franca,202503,10397,2088,1503,13988,17.592,"79,51%","59,10%"
210800,Ma-Pastos Bons,202503,9901,1788,1434,13123,19.246,"68,19%","51,44%"
210805,Ma-Paulino Neves,202503,11335,2760,1365,15460,17.523,"88,23%","64,69%"
210810,Ma-Paulo Ramos,202503,11877,1855,1374,15106,20.792,"72,65%","57,12%"
210820,Ma-Pedreiras,202503,11242,5986,3716,20944,38.267,"54,73%","29,38%"
210825,Ma-Pedro do Rosario,202503,19383,2154,1863,23400,24.917,"93,91%","77,79%"
210830,Ma-Penalva,202503,19346,2526,1938,23810,33.534,"71,00%","57,69%"
210840,Ma-Peri Mirim,202503,8174,886,1008,10068,11.277,"89,28%","72,48%"
210845,Ma-Peritoro,202503,12034,2087,1620,15741,20.910,"75,28%","57,55%"
210850,Ma-Pindare Mirim,202503,14726,3181,2857,20764,32.521,"63,85%","45,28%"
210860,Ma-Pinheiro,202503,40705,8157,7218,56080,87.919,"63,79%","46,30%"
210870,Ma-Pio Xii,202503,12957,2193,2026,17176,22.369,"76,78%","57,92%"
210880,Ma-Pirapemas,202503,8387,2019,1616,12022,18.120,"66,35%","46,29%"
210890,Ma-Pocao de Pedras,202503,9276,1701,1407,12384,17.444,"70,99%","53,18%"
210900,Ma-Porto Franco,202503,6530,5081,3850,15461,24.517,"63,06%","26,63%"
210905,Ma-Porto Rico do Maranhao,202503,4567,338,510,5415,6.091,"88,90%","74,98%"
210910,Ma-Presidente Dutra,202503,13606,6789,4238,24633,46.578,"52,89%","29,21%"
210920,Ma-Presidente Juscelino,202503,7769,1064,761,9594,11.616,"82,59%","66,88%"
210923,Ma-Presidente Medici,202503,3509,825,639,4973,4.748,"104,74%","73,90%"
210927,Ma-Presidente Sarney,202503,11829,2521,1377,15727,17.913,"87,80%","66,04%"
210930,Ma-Presidente Vargas,202503,6332,1211,1086,8629,10.791,"79,96%","58,68%"
210940,Ma-Primeira Cruz,202503,7499,1812,784,10095,13.922,"72,51%","53,86%"
210945,Ma-Raposa,202503,17346,3283,2192,22821,32.054,"71,20%","54,11%"
210950,Ma-Riachao,202503,9949,2770,2814,15533,22.699,"68,43%","43,83%"
210955,Ma-Ribamar Fiquene,202503,2672,1144,862,4678,7.597,"61,58%","35,17%"
210960,Ma-Rosario,202503,14708,8310,5019,28037,39.763,"70,51%","36,99%"
210970,Ma-Sambaiba,202503,3010,784,851,4645,5.701,"81,48%","52,80%"
210975,Ma-Santa Filomena do Maranhao,202503,3440,1087,473,5000,6.839,"73,11%","50,30%"
210980,Ma-Santa Helena,202503,19672,2038,1887,23597,43.112,"54,73%","45,63%"
210990,Ma-Santa Ines,202503,31697,11402,9039,52138,88.167,"59,14%","35,95%"
211000,Ma-Santa Luzia,202503,30275,6019,5087,41381,59.037,"70,09%","51,28%"
211003,Ma-Santa Luzia do Parua,202503,12880,2136,1860,16876,24.870,"67,86%","51,79%"
211010,Ma-Santa Quiteria do Maranhao,202503,17827,3067,1654,22548,24.489,"92,07%","72,80%"
211020,Ma-Santa Rita,202503,21241,2612,2212,26065,38.446,"67,80%","55,25%"
211023,Ma-Santana do Maranhao,202503,5038,1309,696,7043,10.777,"65,35%","46,75%"
211027,Ma-Santo Amaro do Maranhao,202503,9570,1272,725,11567,14.280,"81,00%","67,02%"
211030,Ma-Santo Antonio dos Lopes,202503,8214,1509,1056,10779,14.623,"73,71%","56,17%"
211040,Ma-Sao Benedito do Rio Preto,202503,13344,1771,1148,16263,18.793,"86,54%","71,01%"
211050,Ma-Sao Bento,202503,18757,3553,2609,24919,48.036,"51,88%","39,05%"
211060,Ma-Sao Bernardo,202503,16846,2751,1946,21543,27.887,"77,25%","60,41%"
211065,Ma-Sao Domingos do Azeitao,202503,4731,851,971,6553,8.213,"79,79%","57,60%"
211070,Ma-Sao Domingos do Maranhao,202503,19231,4085,3447,26763,35.221,"75,99%","54,60%"
211080,Ma-Sao Felix de Balsas,202503,2298,538,644,3480,4.495,"77,42%","51,12%"
211085,Ma-Sao Francisco do Brejao,202503,4647,886,1217,6750,9.222,"73,19%","50,39%"
211090,Ma-Sao Francisco do Maranhao,202503,6810,1106,621,8537,12.353,"69,11%","55,13%"
211100,Ma-Sao Joao Batista,202503,14733,1882,1055,17670,18.909,"93,45%","77,92%"
211102,Ma-Sao Joao do Caru,202503,8197,1527,895,10619,12.421,"85,49%","65,99%"
211105,Ma-Sao Joao do Paraiso,202503,5222,1174,879,7275,10.105,"71,99%","51,68%"
211107,Ma-Sao Joao do Soter,202503,10511,2286,1740,14537,17.254,"84,25%","60,92%"
211110,Ma-Sao Joao dos Patos,202503,11638,2722,2979,17339,25.891,"66,97%","44,95%"
211120,Ma-Sao Jose de Ribamar,202503,71986,29662,20362,122010,257.414,"47,40%","27,97%"
211125,Ma-Sao Jose dos Basilios,202503,3575,1011,672,5258,7.102,"74,04%","50,34%"
211130,Ma-Sao Luis,202503,298112,110559,96331,505002,1.088.057,"46,41%","27,40%"
211140,Ma-Sao Luis Gonzaga do Maranhao,202503,9765,2442,1910,14117,18.153,"77,77%","53,79%"
211150,Ma-Sao Mateus do Maranhao,202503,18107,4538,3757,26402,40.160,"65,74%","45,09%"
211153,Ma-Sao Pedro da Agua Branca,202503,5104,1730,2051,8885,14.736,"60,29%","34,64%"
211157,Ma-Sao Pedro dos Crentes,202503,2742,848,522,4112,5.965,"68,94%","45,97%"
211160,Ma-Sao Raimundo das Mangabeiras,202503,8935,2454,2364,13753,19.129,"71,90%","46,71%"
211163,Ma-Sao Raimundo do Doca Bezerra,202503,3638,608,438,4684,5.767,"81,22%","63,08%"
211167,Ma-Sao Roberto,202503,3464,795,428,4687,4.602,"101,85%","75,27%"
211170,Ma-Sao Vicente Ferrer,202503,13247,1828,1407,16482,19.885,"82,89%","66,62%"
211172,Ma-Satubinha,202503,4974,1232,997,7203,8.880,"81,11%","56,01%"
211174,Ma-Senador Alexandre Costa,202503,7700,729,620,9049,10.445,"86,63%","73,72%"
211176,Ma-Senador La Rocque,202503,8303,1811,1947,12061,15.035,"80,22%","55,22%"
211178,Ma-Serrano do Maranhao,202503,9937,874,1163,11974,10.461,"114,46%","94,99%"
211180,Ma-Sitio Novo,202503,9929,2579,1158,13666,17.457,"78,28%","56,88%"
211190,Ma-Sucupira do Norte,202503,6637,1263,1162,9062,10.471,"86,54%","63,38%"
211195,Ma-Sucupira do Riachao,202503,2780,711,655,4146,5.088,"81,49%","54,64%"
211200,Ma-Tasso Fragoso,202503,3607,1405,1500,6512,9.106,"71,51%","39,61%"
211210,Ma-Timbiras,202503,13839,3295,1927,19061,27.344,"69,71%","50,61%"
211220,Ma-Timon,202503,68036,21803,17283,107122,182.241,"58,78%","37,33%"
211223,Ma-Trizidela do Vale,202503,7737,4003,2507,14247,23.052,"61,80%","33,56%"
211227,Ma-Tufilandia,202503,4081,816,529,5426,5.633,"96,33%","72,45%"
211230,Ma-Tuntum,202503,18488,2986,2993,24467,37.401,"65,42%","49,43%"
211240,Ma-Turiacu,202503,24535,1983,1719,28237,38.905,"72,58%","63,06%"
211245,Ma-Turilandia,202503,14451,1377,1389,17217,33.032,"52,12%","43,75%"
211250,Ma-Tutoia,202503,33927,7584,4497,46008,55.041,"83,59%","61,64%"
211260,Ma-Urbano Santos,202503,20693,3302,2158,26153,34.060,"76,79%","60,75%"
211270,Ma-Vargem Grande,202503,22170,5801,3094,31065,44.540,"69,75%","49,78%"
211280,Ma-Viana,202503,28646,5549,3816,38011,53.115,"71,56%","53,93%"
211285,Ma-Vila Nova dos Martirios,202503,4415,1588,806,6809,10.575,"64,39%","41,75%"
211290,Ma-Vitoria do Mearim,202503,15459,4114,2535,22108,31.851,"69,41%","48,54%"
211300,Ma-Vitorino Freire,202503,13559,4350,2915,20824,31.906,"65,27%","42,50%"
211400,Ma-Ze Doca,202503,20286,6159,4981,31426,41.943,"74,93%","48,37%"
220005,Pi-Acaua,202503,3544,944,692,5180,6.515,"79,51%","54,40%"
220010,Pi-Agricolandia,202503,2378,882,960,4220,5.023,"84,01%","47,34%"
220020,Pi-Agua Branca,202503,8704,1684,1995,12383,18.033,"68,67%","48,27%"
220025,Pi-Alagoinha do Piaui,202503,3258,806,797,4861,6.901,"70,44%","47,21%"
220027,Pi-Alegrete do Piaui,202503,2213,571,569,3353,4.713,"71,14%","46,96%"
220030,Pi-Alto Longa,202503,6918,1174,1455,9547,13.734,"69,51%","50,37%"
220040,Pi-Altos,202503,15897,7090,4993,27980,49.637,"56,37%","32,03%"
220045,Pi-Alvorada do Gurgueia,202503,2957,985,853,4795,5.459,"87,84%","54,17%"
220050,Pi-Amarante,202503,8945,2043,1798,12786,17.577,"72,74%","50,89%"
220060,Pi-Angical do Piaui,202503,3993,470,791,5254,6.982,"75,25%","57,19%"
220070,Pi-Anisio de Abreu,202503,4048,1106,1027,6181,9.631,"64,18%","42,03%"
220080,Pi-Antonio Almeida,202503,1315,552,343,2210,3.228,"68,46%","40,74%"
220090,Pi-Aroazes,202503,2604,578,728,3910,5.433,"71,97%","47,93%"
220095,Pi-Aroeiras do Itaim,202503,1654,243,289,2186,2.766,"79,03%","59,80%"
220100,Pi-Arraial,202503,2287,691,897,3875,4.593,"84,37%","49,79%"
220105,Pi-Assuncao do Piaui,202503,4071,1354,1047,6472,7.597,"85,19%","53,59%"
220110,Pi-Avelino Lopes,202503,6018,1662,1605,9285,11.106,"83,60%","54,19%"
220115,Pi-Baixa Grande do Ribeiro,202503,6017,1810,1130,8957,13.838,"64,73%","43,48%"
220117,Pi-Barra D Alcantara,202503,2015,520,752,3287,4.091,"80,35%","49,25%"
220120,Pi-Barras,202503,29087,4460,3471,37018,49.533,"74,73%","58,72%"
220130,Pi-Barreiras do Piaui,202503,1956,454,441,2851,3.334,"85,51%","58,67%"
220140,Pi-Barro Duro,202503,3306,617,757,4680,6.744,"69,40%","49,02%"
220150,Pi-Batalha,202503,12841,3609,2870,19320,27.123,"71,23%","47,34%"
220155,Pi-Bela Vista do Piaui,202503,1967,954,793,3714,4.208,"88,26%","46,74%"
220157,Pi-Belem do Piaui,202503,1497,672,471,2640,3.508,"75,26%","42,67%"
220160,Pi-Beneditinos,202503,5107,1191,1471,7769,10.104,"76,89%","50,54%"
220170,Pi-Bertolinia,202503,2520,731,701,3952,5.701,"69,32%","44,20%"
220173,Pi-Betania do Piaui,202503,3818,1157,1444,6419,6.368,"100,80%","59,96%"
220177,Pi-Boa Hora,202503,5022,562,402,5986,7.108,"84,21%","70,65%"
220180,Pi-Bocaina,202503,1687,536,586,2809,4.131,"68,00%","40,84%"
220190,Pi-Bom Jesus,202503,11226,3709,3016,17951,30.321,"59,20%","37,02%"
220191,Pi-Bom Principio do Piaui,202503,3595,958,652,5205,5.786,"89,96%","62,13%"
220192,Pi-Bonfim do Piaui,202503,3203,866,1185,5254,6.089,"86,29%","52,60%"
220194,Pi-Boqueirao do Piaui,202503,3620,756,917,5293,6.728,"78,67%","53,80%"
220196,Pi-Brasileira,202503,3916,986,776,5678,8.658,"65,58%","45,23%"
220198,Pi-Brejo do Piaui,202503,2524,381,444,3349,3.969,"84,38%","63,59%"
220200,Pi-Buriti dos Lopes,202503,10560,3056,1844,15460,20.096,"76,93%","52,55%"
220202,Pi-Buriti dos Montes,202503,4005,1073,1054,6132,7.538,"81,35%","53,13%"
220205,Pi-Cabeceiras do Piaui,202503,4857,1379,1335,7571,10.449,"72,46%","46,48%"
220207,Pi-Cajazeiras do Piaui,202503,1262,684,444,2390,3.146,"75,97%","40,11%"
220208,Pi-Cajueiro da Praia,202503,3109,2103,1207,6419,8.203,"78,25%","37,90%"
220209,Pi-Caldeirao Grande do Piaui,202503,3014,838,1084,4936,5.605,"88,06%","53,77%"
220210,Pi-Campinas do Piaui,202503,2771,777,939,4487,4.988,"89,96%","55,55%"
220211,Pi-Campo Alegre do Fidalgo,202503,2932,525,550,4007,4.701,"85,24%","62,37%"
220213,Pi-Campo Grande do Piaui,202503,2735,1054,1048,4837,6.188,"78,17%","44,20%"
220217,Pi-Campo Largo do Piaui,202503,5644,545,440,6629,7.636,"86,81%","73,91%"
220220,Pi-Campo Maior,202503,20539,5455,5706,31700,47.074,"67,34%","43,63%"
220225,Pi-Canavieira,202503,1912,220,372,2504,3.429,"73,02%","55,76%"
220230,Pi-Canto do Buriti,202503,9947,2035,2025,14007,19.669,"71,21%","50,57%"
220240,Pi-Capitao de Campos,202503,6507,1551,1880,9938,11.347,"87,58%","57,35%"
220245,Pi-Capitao Gervasio Oliveira,202503,2605,453,619,3677,4.065,"90,46%","64,08%"
220250,Pi-Caracol,202503,6225,1271,783,8279,10.538,"78,56%","59,07%"
220253,Pi-Caraubas do Piaui,202503,3076,887,898,4861,5.755,"84,47%","53,45%"
220255,Pi-Caridade do Piaui,202503,2963,936,866,4765,5.162,"92,31%","57,40%"
220260,Pi-Castelo do Piaui,202503,9637,2346,2604,14587,19.663,"74,19%","49,01%"
220265,Pi-Caxingo,202503,3360,929,498,4787,5.657,"84,62%","59,40%"
220270,Pi-Cocal,202503,14887,4352,2091,21330,29.209,"73,03%","50,97%"
220271,Pi-Cocal de Telha,202503,2661,525,574,3760,5.034,"74,69%","52,86%"
220272,Pi-Cocal dos Alves,202503,3219,1222,954,5395,6.569,"82,13%","49,00%"
220273,Pi-Coivaras,202503,2269,796,825,3890,4.233,"91,90%","53,60%"
220275,Pi-Colonia do Gurgueia,202503,3815,617,913,5345,6.287,"85,02%","60,68%"
220277,Pi-Colonia do Piaui,202503,3629,849,1027,5505,7.088,"77,67%","51,20%"
220280,Pi-Conceicao do Caninde,202503,3017,511,727,4255,5.063,"84,04%","59,59%"
220285,Pi-Coronel Jose Dias,202503,2955,434,544,3933,4.305,"91,36%","68,64%"
220290,Pi-Corrente,202503,10445,4989,3885,19319,28.275,"68,33%","36,94%"
220300,Pi-Cristalandia do Piaui,202503,3244,1406,977,5627,7.454,"75,49%","43,52%"
220310,Pi-Cristino Castro,202503,5450,1570,1406,8426,10.772,"78,22%","50,59%"
220320,Pi-Curimata,202503,5620,1758,1886,9264,11.552,"80,19%","48,65%"
220323,Pi-Currais,202503,2810,1044,1047,4901,4.968,"98,65%","56,56%"
220325,Pi-Curralinhos,202503,2279,874,764,3917,4.527,"86,53%","50,34%"
220327,Pi-Curral Novo do Piaui,202503,3572,757,687,5016,5.185,"96,74%","68,89%"
220330,Pi-Demerval Lobao,202503,9007,1966,1518,12491,16.998,"73,49%","52,99%"
220335,Pi-Dirceu Arcoverde,202503,3855,809,555,5219,7.238,"72,11%","53,26%"
220340,Pi-Dom Expedito Lopes,202503,2621,1207,1358,5186,6.421,"80,77%","40,82%"
220342,Pi-Domingos Mourao,202503,2449,537,534,3520,4.138,"85,07%","59,18%"
220345,Pi-Dom Inocencio,202503,4612,1007,1575,7194,9.335,"77,06%","49,41%"
220350,Pi-Elesbao Veloso,202503,4576,2159,1905,8640,13.786,"62,67%","33,19%"
220360,Pi-Eliseu Martins,202503,2195,510,809,3514,4.435,"79,23%","49,49%"
220370,Pi-Esperantina,202503,18980,4915,3141,27036,42.510,"63,60%","44,65%"
220375,Pi-Fartura do Piaui,202503,3983,340,384,4707,5.414,"86,94%","73,57%"
220380,Pi-Flores do Piaui,202503,2533,380,742,3655,4.508,"81,08%","56,19%"
220385,Pi-Floresta do Piaui,202503,1305,260,606,2171,2.364,"91,84%","55,20%"
220390,Pi-Floriano,202503,17456,8036,7388,32880,64.150,"51,25%","27,21%"
220400,Pi-Francinopolis,202503,2013,812,1078,3903,4.517,"86,41%","44,56%"
220410,Pi-Francisco Ayres,202503,2123,568,676,3367,4.494,"74,92%","47,24%"
220415,Pi-Francisco Macedo,202503,1351,467,632,2450,2.986,"82,05%","45,24%"
220420,Pi-Francisco Santos,202503,2792,1371,1408,5571,8.366,"66,59%","33,37%"
220430,Pi-Fronteiras,202503,4918,1292,1123,7333,10.382,"70,63%","47,37%"
220435,Pi-Geminiano,202503,3517,872,1025,5414,5.587,"96,90%","62,95%"
220440,Pi-Gilbues,202503,5961,1508,1273,8742,11.166,"78,29%","53,39%"
220450,Pi-Guadalupe,202503,4885,980,1096,6961,10.478,"66,43%","46,62%"
220455,Pi-Guaribas,202503,3537,391,280,4208,4.350,"96,74%","81,31%"
220460,Pi-Hugo Napoleao,202503,1849,407,360,2616,3.562,"73,44%","51,91%"
220465,Pi-Ilha Grande,202503,5228,1611,994,7833,9.501,"82,44%","55,03%"
220470,Pi-Inhuma,202503,6480,2241,1831,10552,15.259,"69,15%","42,47%"
220480,Pi-Ipiranga do Piaui,202503,3768,1881,1501,7150,9.620,"74,32%","39,17%"
220490,Pi-Isaias Coelho,202503,4390,805,1061,6256,7.886,"79,33%","55,67%"
220500,Pi-Itainopolis,202503,4899,1705,2050,8654,10.980,"78,82%","44,62%"
220510,Pi-Itaueira,202503,4816,1022,1235,7073,10.493,"67,41%","45,90%"
220515,Pi-Jacobina do Piaui,202503,3384,587,567,4538,5.715,"79,41%","59,21%"
220520,Pi-Jaicos,202503,9113,2327,1891,13331,17.811,"74,85%","51,17%"
220525,Pi-Jardim do Mulato,202503,2458,444,587,3489,4.251,"82,07%","57,82%"
220527,Pi-Jatoba do Piaui,202503,3067,456,854,4377,4.568,"95,82%","67,14%"
220530,Pi-Jerumenha,202503,2314,598,649,3561,4.600,"77,41%","50,30%"
220535,Pi-Joao Costa,202503,1460,580,349,2389,3.031,"78,82%","48,17%"
220540,Pi-Joaquim Pires,202503,6880,2044,1320,10244,14.175,"72,27%","48,54%"
220545,Pi-Joca Marques,202503,3599,600,532,4731,5.535,"85,47%","65,02%"
220550,Pi-Jose de Freitas,202503,17408,7413,4743,29564,44.391,"66,60%","39,22%"
220551,Pi-Juazeiro do Piaui,202503,2791,672,666,4129,5.311,"77,74%","52,55%"
220552,Pi-Julio Borges,202503,2713,985,983,4681,5.499,"85,12%","49,34%"
220553,Pi-Jurema,202503,3571,603,721,4895,4.505,"108,66%","79,27%"
220554,Pi-Lagoinha do Piaui,202503,1436,433,547,2416,3.029,"79,76%","47,41%"
220555,Pi-Lagoa Alegre,202503,6796,832,1377,9005,8.449,"106,58%","80,44%"
220556,Pi-Lagoa do Barro do Piaui,202503,2251,949,892,4092,5.146,"79,52%","43,74%"
220557,Pi-Lagoa de Sao Francisco,202503,3135,1132,1602,5869,6.449,"91,01%","48,61%"
220558,Pi-Lagoa do Piaui,202503,2605,561,661,3827,5.009,"76,40%","52,01%"
220559,Pi-Lagoa do Sitio,202503,3073,704,844,4621,4.575,"101,01%","67,17%"
220560,Pi-Landri Sales,202503,3104,616,653,4373,5.311,"82,34%","58,44%"
220570,Pi-Luis Correia,202503,15338,6069,3439,24846,31.775,"78,19%","48,27%"
220580,Pi-Luzilandia,202503,13753,2798,1993,18544,26.204,"70,77%","52,48%"
220585,Pi-Madeiro,202503,4604,968,1147,6719,8.218,"81,76%","56,02%"
220590,Pi-Manoel Emidio,202503,2694,718,779,4191,5.314,"78,87%","50,70%"
220595,Pi-Marcolandia,202503,5568,1482,951,8001,8.783,"91,10%","63,40%"
220600,Pi-Marcos Parente,202503,2444,310,533,3287,4.848,"67,80%","50,41%"
220605,Pi-Massape do Piaui,202503,2596,1057,827,4480,5.215,"85,91%","49,78%"
220610,Pi-Matias Olimpio,202503,6850,882,737,8469,10.875,"77,88%","62,99%"
220620,Pi-Miguel Alves,202503,19822,3121,2703,25646,33.071,"77,55%","59,94%"
220630,Pi-Miguel Leao,202503,490,338,253,1081,1.352,"79,96%","36,24%"
220635,Pi-Milton Brandao,202503,3825,804,871,5500,6.678,"82,36%","57,28%"
220640,Pi-Monsenhor Gil,202503,4062,1704,1126,6892,10.455,"65,92%","38,85%"
220650,Pi-Monsenhor Hipolito,202503,4629,974,1122,6725,7.751,"86,76%","59,72%"
220660,Pi-Monte Alegre do Piaui,202503,5123,1638,1418,8179,10.910,"74,97%","46,96%"
220665,Pi-Morro Cabeca no Tempo,202503,2898,687,605,4190,4.458,"93,99%","65,01%"
220667,Pi-Morro do Chapeu do Piaui,202503,3203,949,569,4721,6.547,"72,11%","48,92%"
220669,Pi-Murici dos Portelas,202503,3903,790,459,5152,10.139,"50,81%","38,49%"
220670,Pi-Nazare do Piaui,202503,3839,766,1070,5675,6.729,"84,34%","57,05%"
220672,Pi-Nazaria,202503,5600,1710,1251,8561,10.706,"79,96%","52,31%"
220675,Pi-Nossa Senhora de Nazare,202503,2479,726,682,3887,5.406,"71,90%","45,86%"
220680,Pi-Nossa Senhora dos Remedios,202503,6570,503,478,7551,8.732,"86,48%","75,24%"
220690,Pi-Novo Oriente do Piaui,202503,2601,831,838,4270,6.178,"69,12%","42,10%"
220695,Pi-Novo Santo Antonio,202503,1844,446,394,2684,2.886,"93,00%","63,89%"
220700,Pi-Oeiras,202503,18138,5134,5788,29060,39.545,"73,49%","45,87%"
220710,Pi-Olho D Agua do Piaui,202503,1313,483,667,2463,2.725,"90,39%","48,18%"
220720,Pi-Padre Marcos,202503,3610,691,714,5015,6.481,"77,38%","55,70%"
220730,Pi-Paes Landim,202503,2432,672,548,3652,4.174,"87,49%","58,27%"
220735,Pi-Pajeu do Piaui,202503,1288,456,649,2393,3.041,"78,69%","42,35%"
220740,Pi-Palmeira do Piaui,202503,2164,640,642,3446,5.048,"68,26%","42,87%"
220750,Pi-Palmeirais,202503,8095,989,1335,10419,13.480,"77,29%","60,05%"
220755,Pi-Paqueta,202503,2353,504,695,3552,3.878,"91,59%","60,68%"
220760,Pi-Parnagua,202503,6652,1095,917,8664,10.289,"84,21%","64,65%"
220770,Pi-Parnaiba,202503,44972,26784,15965,87721,169.552,"51,74%","26,52%"
220775,Pi-Passagem Franca do Piaui,202503,2818,312,395,3525,4.220,"83,53%","66,78%"
220777,Pi-Patos do Piaui,202503,2303,818,820,3941,5.461,"72,17%","42,17%"
220779,Pi-Pau D Arco do Piaui,202503,2354,523,528,3405,3.972,"85,73%","59,26%"
220780,Pi-Paulistana,202503,11187,2487,2200,15874,21.601,"73,49%","51,79%"
220785,Pi-Pavussu,202503,2842,247,328,3417,3.698,"92,40%","76,85%"
220790,Pi-Pedro Ii,202503,20775,5311,3717,29803,39.039,"76,34%","53,22%"
220793,Pi-Pedro Laurentino,202503,1859,347,446,2652,2.514,"105,49%","73,95%"
220795,Pi-Nova Santa Rita,202503,2538,604,494,3636,4.147,"87,68%","61,20%"
220800,Pi-Picos,202503,26476,9567,9394,45437,86.228,"52,69%","30,70%"
220810,Pi-Pimenteiras,202503,5725,1433,1722,8880,11.528,"77,03%","49,66%"
220820,Pi-Pio Ix,202503,10840,1999,1933,14772,17.947,"82,31%","60,40%"
220830,Pi-Piracuruca,202503,12833,4211,2751,19795,29.849,"66,32%","42,99%"
220840,Pi-Piripiri,202503,24696,8984,7415,41095,67.676,"60,72%","36,49%"
220850,Pi-Porto,202503,7852,1081,832,9765,12.312,"79,31%","63,78%"
220855,Pi-Porto Alegre do Piaui,202503,1661,121,275,2057,2.391,"86,03%","69,47%"
220860,Pi-Prata do Piaui,202503,2004,281,436,2721,3.098,"87,83%","64,69%"
220865,Pi-Queimada Nova,202503,3802,1403,1552,6757,8.936,"75,62%","42,55%"
220870,Pi-Redencao do Gurgueia,202503,5696,1185,1310,8191,8.563,"95,66%","66,52%"
220880,Pi-Regeneracao,202503,10569,1492,1997,14058,17.418,"80,71%","60,68%"
220885,Pi-Riacho Frio,202503,2621,833,716,4170,4.241,"98,33%","61,80%"
220887,Pi-Ribeira do Piaui,202503,2704,291,524,3519,4.114,"85,54%","65,73%"
220890,Pi-Ribeiro Goncalves,202503,2549,938,796,4283,6.215,"68,91%","41,01%"
220900,Pi-Rio Grande do Piaui,202503,3467,664,829,4960,5.868,"84,53%","59,08%"
220910,Pi-Santa Cruz do Piaui,202503,3035,761,849,4645,5.928,"78,36%","51,20%"
220915,Pi-Santa Cruz dos Milagres,202503,1451,574,568,2593,3.466,"74,81%","41,86%"
220920,Pi-Santa Filomena,202503,3113,1027,856,4996,6.209,"80,46%","50,14%"
220930,Pi-Santa Luz,202503,3397,624,699,4720,5.425,"87,00%","62,62%"
220935,Pi-Santana do Piaui,202503,1588,841,1002,3431,4.174,"82,20%","38,05%"
220937,Pi-Santa Rosa do Piaui,202503,2368,692,712,3772,4.690,"80,43%","50,49%"
220940,Pi-Santo Antonio de Lisboa,202503,2990,745,942,4677,5.938,"78,76%","50,35%"
220945,Pi-Santo Antonio dos Milagres,202503,840,539,448,1827,2.189,"83,46%","38,37%"
220950,Pi-Santo Inacio do Piaui,202503,1772,437,1001,3210,3.719,"86,31%","47,65%"
220955,Pi-Sao Braz do Piaui,202503,2612,678,890,4180,4.451,"93,91%","58,68%"
220960,Pi-Sao Felix do Piaui,202503,979,538,556,2073,2.885,"71,85%","33,93%"
220965,Pi-Sao Francisco Assis do Piaui,202503,3494,727,774,4995,5.703,"87,59%","61,27%"
220970,Pi-Sao Francisco do Piaui,202503,3020,575,1019,4614,5.404,"85,38%","55,88%"
220975,Pi-Sao Goncalo do Gurgeia,202503,1520,371,274,2165,3.019,"71,71%","50,35%"
220980,Pi-Sao Goncalo do Piaui,202503,2701,467,410,3578,4.944,"72,37%","54,63%"
220985,Pi-Sao Joao da Canabrava,202503,2338,612,678,3628,4.306,"84,25%","54,30%"
220987,Pi-Sao Joao da Fronteira,202503,3247,646,473,4366,5.615,"77,76%","57,83%"
220990,Pi-Sao Joao da Serra,202503,3113,809,703,4625,6.233,"74,20%","49,94%"
220995,Pi-Sao Joao da Varjota,202503,2449,609,727,3785,4.443,"85,19%","55,12%"
220997,Pi-Sao Joao do Arraial,202503,5322,1046,786,7154,8.443,"84,73%","63,03%"
221000,Pi-Sao Joao do Piaui,202503,8265,2975,2293,13533,22.036,"61,41%","37,51%"
221005,Pi-Sao Jose do Divino,202503,2879,847,622,4348,4.906,"88,63%","58,68%"
221010,Pi-Sao Jose do Peixe,202503,1659,449,471,2579,3.320,"77,68%","49,97%"
221020,Pi-Sao Jose do Piaui,202503,3052,1119,836,5007,6.732,"74,38%","45,34%"
221030,Pi-Sao Juliao,202503,2785,569,585,3939,6.135,"64,21%","45,40%"
221035,Pi-Sao Lourenco do Piaui,202503,2512,638,739,3889,4.497,"86,48%","55,86%"
221037,Pi-Sao Luis do Piaui,202503,1051,446,443,1940,2.329,"83,30%","45,13%"
221038,Pi-Sao Miguel da Baixa Grande,202503,821,366,356,1543,2.304,"66,97%","35,63%"
221039,Pi-Sao Miguel do Fidalgo,202503,1400,470,447,2317,2.870,"80,73%","48,78%"
221040,Pi-Sao Miguel do Tapuio,202503,7897,2726,3131,13754,17.902,"76,83%","44,11%"
221050,Pi-Sao Pedro do Piaui,202503,8344,1006,1150,10500,14.046,"74,75%","59,40%"
221060,Pi-Sao Raimundo Nonato,202503,16965,5542,6008,28515,40.784,"69,92%","41,60%"
221062,Pi-Sebastiao Barros,202503,2311,960,649,3920,3.228,"121,44%","71,59%"
221063,Pi-Sebastiao Leal,202503,2123,595,700,3418,4.572,"74,76%","46,43%"
221065,Pi-Sigefredo Pacheco,202503,5028,1043,1329,7400,9.631,"76,84%","52,21%"
221070,Pi-Simoes,202503,6218,2551,2362,11131,14.650,"75,98%","42,44%"
221080,Pi-Simplicio Mendes,202503,5369,2031,1949,9349,14.342,"65,19%","37,44%"
221090,Pi-Socorro do Piaui,202503,2411,426,537,3374,4.184,"80,64%","57,62%"
221093,Pi-Sussuapara,202503,2962,918,753,4633,6.345,"73,02%","46,68%"
221095,Pi-Tamboril do Piaui,202503,1690,387,415,2492,3.029,"82,27%","55,79%"
221097,Pi-Tanque do Piaui,202503,1153,559,597,2309,2.330,"99,10%","49,48%"
221100,Pi-Teresina,202503,218223,101300,65819,385342,902.644,"42,69%","24,18%"
221110,Pi-Uniao,202503,23816,5438,3831,33085,47.707,"69,35%","49,92%"
221120,Pi-Urucui,202503,10380,3045,2180,15605,26.501,"58,88%","39,17%"
221130,Pi-Valenca do Piaui,202503,7627,3400,3757,14784,22.920,"64,50%","33,28%"
221135,Pi-Varzea Branca,202503,3468,697,678,4843,5.173,"93,62%","67,04%"
221140,Pi-Varzea Grande,202503,2231,542,658,3431,4.515,"75,99%","49,41%"
221150,Pi-Vera Mendes,202503,1515,710,771,2996,3.271,"91,59%","46,32%"
221160,Pi-Vila Nova do Piaui,202503,1215,396,380,1991,2.979,"66,83%","40,79%"
221170,Pi-Wall Ferraz,202503,2439,393,385,3217,4.117,"78,14%","59,24%"
230010,Ce-Abaiara,202503,4974,1346,1754,8074,10.282,"78,53%","48,38%"
230015,Ce-Acarape,202503,7081,2750,1855,11686,14.306,"81,69%","49,50%"
230020,Ce-Acarau,202503,34130,7970,4129,46229,68.758,"67,23%","49,64%"
230030,Ce-Acopiara,202503,20774,5947,5414,32135,46.215,"69,53%","44,95%"
230040,Ce-Aiuaba,202503,7673,1681,1777,11131,14.220,"78,28%","53,96%"
230050,Ce-Alcantaras,202503,3415,2732,1901,8048,11.754,"68,47%","29,05%"
230060,Ce-Altaneira,202503,4119,959,1789,6867,6.970,"98,52%","59,10%"
230070,Ce-Alto Santo,202503,6185,2288,3122,11595,14.418,"80,42%","42,90%"
230075,Ce-Amontada,202503,21992,6749,3737,32478,44.342,"73,24%","49,60%"
230080,Ce-Antonina do Norte,202503,4495,784,1068,6347,7.484,"84,81%","60,06%"
230090,Ce-Apuiares,202503,7322,1628,1749,10699,13.219,"80,94%","55,39%"
230100,Ce-Aquiraz,202503,34400,13667,8686,56753,84.737,"66,98%","40,60%"
230110,Ce-Aracati,202503,21213,14726,8617,44556,78.752,"56,58%","26,94%"
230120,Ce-Aracoiaba,202503,11488,5926,4682,22096,26.696,"82,77%","43,03%"
230125,Ce-Ararenda,202503,5013,2052,1836,8901,11.485,"77,50%","43,65%"
230130,Ce-Araripe,202503,10616,3546,3852,18014,20.223,"89,08%","52,49%"
230140,Ce-Aratuba,202503,5840,2706,2422,10968,11.459,"95,72%","50,96%"
230150,Ce-Arneiroz,202503,2567,1284,856,4707,7.619,"61,78%","33,69%"
230160,Ce-Assare,202503,10887,3022,2923,16832,22.212,"75,78%","49,01%"
230170,Ce-Aurora,202503,10329,4162,4598,19089,24.267,"78,66%","42,56%"
230180,Ce-Baixio,202503,2801,806,1028,4635,5.832,"79,48%","48,03%"
230185,Ce-Banabuiu,202503,7531,2678,2546,12755,17.654,"72,25%","42,66%"
230190,Ce-Barbalha,202503,21920,14743,13392,50055,80.217,"62,40%","27,33%"
230195,Ce-Barreira,202503,11604,3571,2057,17232,23.351,"73,80%","49,69%"
230200,Ce-Barro,202503,8537,3209,3953,15699,19.669,"79,82%","43,40%"
230205,Ce-Barroquinha,202503,9092,2311,1553,12956,14.977,"86,51%","60,71%"
230210,Ce-Baturite,202503,15886,5061,3437,24384,36.978,"65,94%","42,96%"
230220,Ce-Beberibe,202503,26042,8152,5099,39293,55.666,"70,59%","46,78%"
230230,Ce-Bela Cruz,202503,13779,4299,2760,20838,34.441,"60,50%","40,01%"
230240,Ce-Boa Viagem,202503,20597,8777,6738,36112,52.169,"69,22%","39,48%"
230250,Ce-Brejo Santo,202503,17203,7747,3767,28717,53.778,"53,40%","31,99%"
230260,Ce-Camocim,202503,26423,11202,7274,44899,65.031,"69,04%","40,63%"
230270,Ce-Campos Sales,202503,10221,4504,4585,19310,26.082,"74,04%","39,19%"
230280,Ce-Caninde,202503,34233,10715,8674,53622,77.207,"69,45%","44,34%"
230290,Ce-Capistrano,202503,8535,2514,1997,13046,17.760,"73,46%","48,06%"
230300,Ce-Caridade,202503,9867,2090,1700,13657,16.419,"83,18%","60,10%"
230310,Ce-Carire,202503,7546,3723,3452,14721,18.075,"81,44%","41,75%"
230320,Ce-Caririacu,202503,13989,4989,4179,23157,27.482,"84,26%","50,90%"
230330,Ce-Carius,202503,7487,2549,3294,13330,17.333,"76,91%","43,20%"
230340,Ce-Carnaubal,202503,7110,3307,2283,12700,17.758,"71,52%","40,04%"
230350,Ce-Cascavel,202503,30038,12964,7496,50498,76.365,"66,13%","39,33%"
230360,Ce-Catarina,202503,4892,1570,1703,8165,9.577,"85,26%","51,08%"
230365,Ce-Catunda,202503,5793,773,938,7504,10.817,"69,37%","53,55%"
230370,Ce-Caucaia,202503,143155,44058,33549,220762,375.730,"58,76%","38,10%"
230380,Ce-Cedro,202503,9793,3850,3898,17541,22.678,"77,35%","43,18%"
230390,Ce-Chaval,202503,6058,2291,1556,9905,12.805,"77,35%","47,31%"
230393,Ce-Choro,202503,5882,1919,2232,10033,12.380,"81,04%","47,51%"
230395,Ce-Chorozinho,202503,9089,3806,3089,15984,20.763,"76,98%","43,77%"
230400,Ce-Coreau,202503,10268,3672,2523,16463,21.438,"76,79%","47,90%"
230410,Ce-Crateus,202503,24691,10594,8340,43625,79.809,"54,66%","30,94%"
230420,Ce-Crato,202503,44453,24622,21435,90510,138.232,"65,48%","32,16%"
230423,Ce-Croata,202503,8470,3143,2253,13866,18.007,"77,00%","47,04%"
230425,Ce-Cruz,202503,13433,4371,2155,19959,31.847,"62,67%","42,18%"
230426,Ce-Deputado Irapuan Pinheiro,202503,3574,1517,2299,7390,9.172,"80,57%","38,97%"
230427,Ce-Erere,202503,2755,1024,1631,5410,6.393,"84,62%","43,09%"
230428,Ce-Eusebio,202503,15410,8717,4975,29102,80.304,"36,24%","19,19%"
230430,Ce-Farias Brito,202503,8510,3249,3213,14972,18.557,"80,68%","45,86%"
230435,Ce-Forquilha,202503,7653,4561,4276,16490,25.127,"65,63%","30,46%"
230440,Ce-Fortaleza,202503,698591,286243,222154,1206988,2.574.412,"46,88%","27,14%"
230445,Ce-Fortim,202503,6416,2962,1815,11193,18.052,"62,00%","35,54%"
230450,Ce-Frecheirinha,202503,6489,2811,1898,11198,16.362,"68,44%","39,66%"
230460,Ce-General Sampaio,202503,4067,1030,740,5837,6.924,"84,30%","58,74%"
230465,Ce-Graca,202503,7169,2136,2553,11858,14.174,"83,66%","50,58%"
230470,Ce-Granja,202503,24289,10366,4727,39382,55.633,"70,79%","43,66%"
230480,Ce-Granjeiro,202503,2519,924,1107,4550,4.960,"91,73%","50,79%"
230490,Ce-Groairas,202503,3886,2261,1873,8020,11.313,"70,89%","34,35%"
230495,Ce-Guaiuba,202503,9518,4293,3415,17226,25.085,"68,67%","37,94%"
230500,Ce-Guaraciaba do Norte,202503,21752,6376,4359,32487,44.294,"73,34%","49,11%"
230510,Ce-Guaramiranga,202503,2673,1099,1184,4956,5.819,"85,17%","45,94%"
230520,Ce-Hidrolandia,202503,8708,2607,1996,13311,18.225,"73,04%","47,78%"
230523,Ce-Horizonte,202503,17895,21270,17720,56885,79.934,"71,16%","22,39%"
230526,Ce-Ibaretama,202503,7008,2022,2087,11117,12.191,"91,19%","57,49%"
230530,Ce-Ibiapina,202503,11071,3994,2854,17919,24.649,"72,70%","44,91%"
230533,Ce-Ibicuitinga,202503,6613,1575,2538,10726,11.979,"89,54%","55,20%"
230535,Ce-Icapui,202503,7629,3954,2027,13610,22.367,"60,85%","34,11%"
230540,Ce-Ico,202503,28379,8365,5300,42044,64.802,"64,88%","43,79%"
230550,Ce-Iguatu,202503,33428,15366,13089,61883,102.251,"60,52%","32,69%"
230560,Ce-Independencia,202503,11898,2415,3535,17848,24.530,"72,76%","48,50%"
230565,Ce-Ipaporanga,202503,4982,2041,1422,8445,11.937,"70,75%","41,74%"
230570,Ce-Ipaumirim,202503,5676,1698,1605,8979,12.441,"72,17%","45,62%"
230580,Ce-Ipu,202503,22732,4101,4517,31350,42.968,"72,96%","52,90%"
230590,Ce-Ipueiras,202503,17184,5472,5554,28210,38.285,"73,68%","44,88%"
230600,Ce-Iracema,202503,5377,2248,2407,10032,14.411,"69,61%","37,31%"
230610,Ce-Iraucuba,202503,13503,3570,2681,19754,24.751,"79,81%","54,56%"
230620,Ce-Itaicaba,202503,3030,1305,1400,5735,7.779,"73,72%","38,95%"
230625,Ce-Itaitinga,202503,17780,9940,6167,33887,70.679,"47,94%","25,16%"
230630,Ce-Itapage,202503,20677,8221,5156,34054,49.086,"69,38%","42,12%"
230640,Ce-Itapipoca,202503,54897,19986,10445,85328,137.892,"61,88%","39,81%"
230650,Ce-Itapiuna,202503,9584,2626,2464,14674,18.228,"80,50%","52,58%"
230655,Ce-Itarema,202503,25229,5620,2406,33255,45.465,"73,14%","55,49%"
230660,Ce-Itatira,202503,11099,3655,3243,17997,21.087,"85,35%","52,63%"
230670,Ce-Jaguaretama,202503,8420,2458,3674,14552,17.625,"82,56%","47,77%"
230680,Ce-Jaguaribara,202503,4393,1734,1953,8080,10.656,"75,83%","41,23%"
230690,Ce-Jaguaribe,202503,10506,5680,4383,20569,35.124,"58,56%","29,91%"
230700,Ce-Jaguaruana,202503,15587,5119,6706,27412,33.070,"82,89%","47,13%"
230710,Ce-Jardim,202503,13332,4818,3674,21824,28.707,"76,02%","46,44%"
230720,Ce-Jati,202503,2956,1661,1292,5909,8.100,"72,95%","36,49%"
230725,Ce-Jijoca de Jericoacoara,202503,9996,4155,1817,15968,27.662,"57,73%","36,14%"
230730,Ce-Juazeiro do Norte,202503,81637,52353,38303,172293,303.004,"56,86%","26,94%"
230740,Ce-Jucas,202503,10220,4013,3481,17714,24.591,"72,03%","41,56%"
230750,Ce-Lavras da Mangabeira,202503,13543,4273,5480,23296,32.123,"72,52%","42,16%"
230760,Ce-Limoeiro do Norte,202503,19234,8280,6622,34136,62.285,"54,81%","30,88%"
230763,Ce-Madalena,202503,7978,2918,2465,13361,17.264,"77,39%","46,21%"
230765,Ce-Maracanau,202503,75442,37222,25589,138253,249.684,"55,37%","30,21%"
230770,Ce-Maranguape,202503,42443,13489,11800,67732,108.937,"62,18%","38,96%"
230780,Ce-Marco,202503,15004,5783,3116,23903,27.064,"88,32%","55,44%"
230790,Ce-Martinopole,202503,6266,1970,1005,9241,11.232,"82,27%","55,79%"
230800,Ce-Massape,202503,15761,7621,5023,28405,39.633,"71,67%","39,77%"
230810,Ce-Mauriti,202503,20095,8020,6408,34523,47.406,"72,82%","42,39%"
230820,Ce-Meruoca,202503,5943,3637,2523,12103,15.749,"76,85%","37,74%"
230830,Ce-Milagres,202503,12230,4190,4083,20503,26.860,"76,33%","45,53%"
230835,Ce-Milha,202503,6070,1725,1916,9711,14.635,"66,35%","41,48%"
230837,Ce-Miraima,202503,8007,1563,1514,11084,14.736,"75,22%","54,34%"
230840,Ce-Missao Velha,202503,19775,5740,4734,30249,38.767,"78,03%","51,01%"
230850,Ce-Mombaca,202503,18297,5674,4903,28874,38.649,"74,71%","47,34%"
230860,Ce-Monsenhor Tabosa,202503,10214,1728,2652,14594,17.664,"82,62%","57,82%"
230870,Ce-Morada Nova,202503,25407,7285,7957,40649,65.323,"62,23%","38,89%"
230880,Ce-Moraujo,202503,3982,1465,822,6269,8.516,"73,61%","46,76%"
230890,Ce-Morrinhos,202503,9916,3956,1784,15656,23.608,"66,32%","42,00%"
230900,Ce-Mucambo,202503,5541,2606,2564,10711,14.009,"76,46%","39,55%"
230910,Ce-Mulungu,202503,5938,1428,1591,8957,10.993,"81,48%","54,02%"
230920,Ce-Nova Olinda,202503,7849,2987,3475,14311,15.960,"89,67%","49,18%"
230930,Ce-Nova Russas,202503,11541,5032,4918,21491,32.014,"67,13%","36,05%"
230940,Ce-Novo Oriente,202503,15189,3037,2720,20946,29.043,"72,12%","52,30%"
230945,Ce-Ocara,202503,11670,4447,3005,19122,25.218,"75,83%","46,28%"
230950,Ce-Oros,202503,10995,2737,2379,16111,20.019,"80,48%","54,92%"
230960,Ce-Pacajus,202503,18413,12821,7525,38759,74.825,"51,80%","24,61%"
230970,Ce-Pacatuba,202503,24576,12944,8836,46356,85.873,"53,98%","28,62%"
230980,Ce-Pacoti,202503,5542,1577,1814,8933,11.442,"78,07%","48,44%"
230990,Ce-Pacuja,202503,2980,1115,973,5068,6.345,"79,87%","46,97%"
231000,Ce-Palhano,202503,4430,1488,2159,8077,9.671,"83,52%","45,81%"
231010,Ce-Palmacia,202503,4881,1333,2267,8481,10.339,"82,03%","47,21%"
231020,Ce-Paracuru,202503,16671,6465,4544,27680,41.447,"66,78%","40,22%"
231025,Ce-Paraipaba,202503,16300,4477,2907,23684,33.896,"69,87%","48,09%"
231030,Ce-Parambu,202503,11898,6128,5611,23637,32.816,"72,03%","36,26%"
231040,Ce-Paramoti,202503,5733,1335,1549,8617,10.528,"81,85%","54,45%"
231050,Ce-Pedra Branca,202503,18550,5335,7282,31167,42.257,"73,76%","43,90%"
231060,Ce-Penaforte,202503,5889,1390,1039,8318,9.308,"89,36%","63,27%"
231070,Ce-Pentecoste,202503,15140,5649,2996,23785,39.715,"59,89%","38,12%"
231080,Ce-Pereiro,202503,5902,2703,2339,10944,15.869,"68,96%","37,19%"
231085,Ce-Pindoretama,202503,10327,4355,2905,17587,24.607,"71,47%","41,97%"
231090,Ce-Piquet Carneiro,202503,5889,2751,2977,11617,17.202,"67,53%","34,23%"
231095,Ce-Pires Ferreira,202503,3900,1484,1646,7030,10.952,"64,19%","35,61%"
231100,Ce-Poranga,202503,5191,2067,1860,9118,12.423,"73,40%","41,79%"
231110,Ce-Porteiras,202503,7296,2981,1697,11974,17.745,"67,48%","41,12%"
231120,Ce-Potengi,202503,4513,1579,1457,7549,8.926,"84,57%","50,56%"
231123,Ce-Potiretama,202503,2735,1333,1288,5356,6.129,"87,39%","44,62%"
231126,Ce-Quiterianopolis,202503,9458,2661,3603,15722,20.506,"76,67%","46,12%"
231130,Ce-Quixada,202503,36626,14014,11879,62519,88.483,"70,66%","41,39%"
231135,Ce-Quixelo,202503,7198,2744,2210,12152,16.992,"71,52%","42,36%"
231140,Ce-Quixeramobim,202503,28600,12748,9387,50735,85.797,"59,13%","33,33%"
231150,Ce-Quixere,202503,5784,5370,3886,15040,21.607,"69,61%","26,77%"
231160,Ce-Redencao,202503,12631,5390,3780,21801,28.359,"76,88%","44,54%"
231170,Ce-Reriutaba,202503,8278,3285,2894,14457,19.059,"75,85%","43,43%"
231180,Ce-Russas,202503,21777,13150,11117,46044,74.582,"61,74%","29,20%"
231190,Ce-Saboeiro,202503,7292,2163,2896,12351,14.036,"88,00%","51,95%"
231195,Ce-Salitre,202503,10000,3459,2920,16379,17.220,"95,12%","58,07%"
231200,Ce-Santana do Acarau,202503,15870,4549,3415,23834,32.043,"74,38%","49,53%"
231210,Ce-Santana do Cariri,202503,9146,2806,2744,14696,17.388,"84,52%","52,60%"
231220,Ce-Santa Quiteria,202503,18588,6656,7753,32997,41.647,"79,23%","44,63%"
231230,Ce-Sao Benedito,202503,20561,8227,4609,33397,49.829,"67,02%","41,26%"
231240,Ce-Sao Goncalo do Amarante,202503,20716,10467,7113,38296,57.499,"66,60%","36,03%"
231250,Ce-Sao Joao do Jaguaribe,202503,2030,820,1826,4676,5.792,"80,73%","35,05%"
231260,Ce-Sao Luis do Curu,202503,5509,2101,1629,9239,10.962,"84,28%","50,26%"
231270,Ce-Senador Pompeu,202503,9253,3608,2899,15760,25.143,"62,68%","36,80%"
231280,Ce-Senador Sa,202503,3625,1459,930,6014,7.519,"79,98%","48,21%"
231290,Ce-Sobral,202503,52296,36847,21976,111119,215.286,"51,61%","24,29%"
231300,Ce-Solonopole,202503,5753,2781,2685,11219,18.736,"59,88%","30,71%"
231310,Ce-Tabuleiro do Norte,202503,11739,4220,6151,22110,32.044,"69,00%","36,63%"
231320,Ce-Tamboril,202503,11522,4156,4161,19839,25.331,"78,32%","45,49%"
231325,Ce-Tarrafas,202503,3524,1276,1837,6637,7.626,"87,03%","46,21%"
231330,Ce-Taua,202503,19630,7744,8216,35590,64.255,"55,39%","30,55%"
231335,Ce-Tejucuoca,202503,10323,2355,1937,14615,17.626,"82,92%","58,57%"
231340,Ce-Tiangua,202503,36769,15635,9144,61548,86.137,"71,45%","42,69%"
231350,Ce-Trairi,202503,34154,7633,4848,46635,61.516,"75,81%","55,52%"
231355,Ce-Tururu,202503,9408,2574,2112,14094,15.457,"91,18%","60,87%"
231360,Ce-Ubajara,202503,16424,5612,4061,26097,34.312,"76,06%","47,87%"
231370,Ce-Umari,202503,3166,1213,1229,5608,6.993,"80,19%","45,27%"
231375,Ce-Umirim,202503,8648,2890,1789,13327,17.804,"74,85%","48,57%"
231380,Ce-Uruburetama,202503,11594,2554,1633,15781,21.279,"74,16%","54,49%"
231390,Ce-Uruoca,202503,6518,2588,1414,10520,14.243,"73,86%","45,76%"
231395,Ce-Varjota,202503,8151,2917,2172,13240,18.660,"70,95%","43,68%"
231400,Ce-Varzea Alegre,202503,17088,6646,5348,29082,40.771,"71,33%","41,91%"
231410,Ce-Vicosa do Ceara,202503,34399,9433,6790,50622,62.609,"80,85%","54,94%"
240010,Rn-Acari,202503,2739,1933,1552,6224,10.865,"57,28%","25,21%"
240020,Rn-Acu,202503,20801,10390,9739,40930,58.906,"69,48%","35,31%"
240030,Rn-Afonso Bezerra,202503,5997,1300,1364,8661,11.149,"77,68%","53,79%"
240040,Rn-Agua Nova,202503,1217,686,524,2427,3.028,"80,15%","40,19%"
240050,Rn-Alexandria,202503,5315,2070,2410,9795,14.042,"69,76%","37,85%"
240060,Rn-Almino Afonso,202503,2322,676,952,3950,4.806,"82,19%","48,31%"
240070,Rn-Alto do Rodrigues,202503,4449,1819,1990,8258,12.857,"64,23%","34,60%"
240080,Rn-Angicos,202503,4017,2013,2138,8168,11.973,"68,22%","33,55%"
240090,Rn-Antonio Martins,202503,3777,644,1099,5520,6.738,"81,92%","56,06%"
240100,Rn-Apodi,202503,14752,5259,6272,26283,37.390,"70,29%","39,45%"
240110,Rn-Areia Branca,202503,7521,4002,3930,15453,24.643,"62,71%","30,52%"
240120,Rn-Ares,202503,5411,2740,1850,10001,13.657,"73,23%","39,62%"
240130,Rn-Augusto Severo,202503,5702,778,1522,8002,10.045,"79,66%","56,76%"
240140,Rn-Baia Formosa,202503,2967,1767,1361,6095,9.098,"66,99%","32,61%"
240145,Rn-Barauna,202503,11399,5266,4958,21623,28.268,"76,49%","40,32%"
240150,Rn-Barcelona,202503,1593,643,636,2872,4.103,"70,00%","38,83%"
240160,Rn-Bento Fernandes,202503,2741,738,950,4429,4.920,"90,02%","55,71%"
240165,Rn-Bodo,202503,1554,515,620,2689,2.363,"113,80%","65,76%"
240170,Rn-Bom Jesus,202503,4468,1603,1405,7476,10.279,"72,73%","43,47%"
240180,Rn-Brejinho,202503,4681,2449,1648,8778,12.603,"69,65%","37,14%"
240185,Rn-Caicara do Norte,202503,3176,914,705,4795,6.474,"74,07%","49,06%"
240190,Rn-Caicara do Rio do Vento,202503,2059,537,554,3150,3.359,"93,78%","61,30%"
240200,Rn-Caico,202503,16420,8197,9650,34267,63.339,"54,10%","25,92%"
240210,Rn-Campo Redondo,202503,4700,1512,1415,7627,10.504,"72,61%","44,74%"
240220,Rn-Canguaretama,202503,14523,4713,3111,22347,30.806,"72,54%","47,14%"
240230,Rn-Caraubas,202503,8427,3269,3496,15192,20.161,"75,35%","41,80%"
240240,Rn-Carnauba dos Dantas,202503,1754,2000,1744,5498,8.267,"66,51%","21,22%"
240250,Rn-Carnaubais,202503,4561,1487,1565,7613,10.010,"76,05%","45,56%"
240260,Rn-Ceara-Mirim,202503,27231,14492,8128,49851,83.009,"60,05%","32,80%"
240270,Rn-Cerro Cora,202503,4083,1787,1567,7437,11.322,"65,69%","36,06%"
240280,Rn-Coronel Ezequiel,202503,2570,787,800,4157,5.241,"79,32%","49,04%"
240290,Rn-Coronel Joao Pessoa,202503,1683,885,772,3340,4.315,"77,40%","39,00%"
240300,Rn-Cruzeta,202503,2818,1383,1338,5539,8.238,"67,24%","34,21%"
240310,Rn-Currais Novos,202503,10648,7628,6002,24278,42.930,"56,55%","24,80%"
240320,Rn-Doutor Severiano,202503,2501,1331,1417,5249,7.253,"72,37%","34,48%"
240325,Rn-Parnamirim,202503,53569,28399,22359,104327,269.298,"38,74%","19,89%"
240330,Rn-Encanto,202503,2580,1312,1316,5208,6.252,"83,30%","41,27%"
240340,Rn-Equador,202503,2714,814,1031,4559,5.476,"83,25%","49,56%"
240350,Rn-Espirito Santo,202503,4622,926,807,6355,10.936,"58,11%","42,26%"
240360,Rn-Extremoz,202503,23005,10530,6480,40015,66.993,"59,73%","34,34%"
240370,Rn-Felipe Guerra,202503,2630,1271,1675,5576,6.458,"86,34%","40,72%"
240375,Rn-Fernando Pedrosa,202503,1257,541,601,2399,3.029,"79,20%","41,50%"
240380,Rn-Florania,202503,3465,1718,1749,6932,10.528,"65,84%","32,91%"
240390,Rn-Francisco Dantas,202503,948,677,855,2480,2.763,"89,76%","34,31%"
240400,Rn-Frutuoso Gomes,202503,1788,963,835,3586,4.231,"84,76%","42,26%"
240410,Rn-Galinhos,202503,677,666,433,1776,2.160,"82,22%","31,34%"
240420,Rn-Goianinha,202503,10892,4718,2669,18279,28.212,"64,79%","38,61%"
240430,Rn-Governador Dix-Sept Rosado,202503,5051,1924,2111,9086,12.239,"74,24%","41,27%"
240440,Rn-Grossos,202503,4477,1130,1273,6880,10.251,"67,12%","43,67%"
240450,Rn-Guamare,202503,6011,2909,2948,11868,15.947,"74,42%","37,69%"
240460,Rn-Ielmo Marinho,202503,6171,1839,1244,9254,11.903,"77,75%","51,84%"
240470,Rn-Ipanguacu,202503,4234,3132,3351,10717,14.539,"73,71%","29,12%"
240480,Rn-Ipueira,202503,524,483,543,1550,2.090,"74,16%","25,07%"
240485,Rn-Itaja,202503,2817,1617,1612,6046,7.531,"80,28%","37,41%"
240490,Rn-Itau,202503,2530,693,1289,4512,5.452,"82,76%","46,40%"
240500,Rn-Jacana,202503,3939,1188,1035,6162,8.051,"76,54%","48,93%"
240510,Rn-Jandaira,202503,3066,910,874,4850,6.748,"71,87%","45,44%"
240520,Rn-Janduis,202503,2334,644,982,3960,4.834,"81,92%","48,28%"
240530,Rn-Boa Saude,202503,4621,1060,792,6473,8.836,"73,26%","52,30%"
240540,Rn-Japi,202503,4045,716,940,5701,5.231,"108,98%","77,33%"
240550,Rn-Jardim de Angicos,202503,1627,321,326,2274,2.493,"91,22%","65,26%"
240560,Rn-Jardim de Piranhas,202503,7148,1610,1237,9995,14.416,"69,33%","49,58%"
240570,Rn-Jardim do Serido,202503,2327,2241,2734,7302,11.952,"61,09%","19,47%"
240580,Rn-Joao Camara,202503,16833,4571,3664,25068,34.768,"72,10%","48,42%"
240590,Rn-Joao Dias,202503,1221,376,426,2023,2.093,"96,66%","58,34%"
240600,Rn-Jose da Penha,202503,2406,1182,1439,5027,5.964,"84,29%","40,34%"
240610,Rn-Jucurutu,202503,6782,2834,2537,12153,18.286,"66,46%","37,09%"
240615,Rn-Jundia,202503,1991,690,663,3344,3.859,"86,65%","51,59%"
240620,Rn-Lagoa D Anta,202503,3603,1013,990,5606,6.733,"83,26%","53,51%"
240630,Rn-Lagoa de Pedras,202503,4599,777,771,6147,7.577,"81,13%","60,70%"
240640,Rn-Lagoa de Velhos,202503,1331,556,495,2382,2.633,"90,47%","50,55%"
240650,Rn-Lagoa Nova,202503,6725,3202,2691,12618,16.126,"78,25%","41,70%"
240660,Rn-Lagoa Salgada,202503,6744,1090,1173,9007,8.619,"104,50%","78,25%"
240670,Rn-Lajes,202503,3560,1747,1969,7276,10.108,"71,98%","35,22%"
240680,Rn-Lajes Pintadas,202503,2328,896,880,4104,4.939,"83,09%","47,14%"
240690,Rn-Lucrecia,202503,1799,555,784,3138,3.579,"87,68%","50,27%"
240700,Rn-Luis Gomes,202503,3982,1555,1353,6890,9.286,"74,20%","42,88%"
240710,Rn-Macaiba,202503,29895,11375,9211,50481,86.433,"58,40%","34,59%"
240720,Rn-Macau,202503,7878,3154,2976,14008,28.384,"49,35%","27,76%"
240725,Rn-Major Sales,202503,1688,873,740,3301,4.067,"81,17%","41,50%"
240730,Rn-Marcelino Vieira,202503,3697,1383,1590,6670,8.092,"82,43%","45,69%"
240740,Rn-Martins,202503,3073,1352,1398,5823,8.411,"69,23%","36,54%"
240750,Rn-Maxaranguape,202503,4349,2078,1312,7739,10.534,"73,47%","41,29%"
240760,Rn-Messias Targino,202503,2356,530,1002,3888,4.404,"88,28%","53,50%"
240770,Rn-Montanhas,202503,6014,1672,1472,9158,11.774,"77,78%","51,08%"
240780,Rn-Monte Alegre,202503,9030,3318,2531,14879,23.843,"62,40%","37,87%"
240790,Rn-Monte das Gameleiras,202503,1414,614,518,2546,2.343,"108,66%","60,35%"
240800,Rn-Mossoro,202503,65362,38568,37138,141068,278.034,"50,74%","23,51%"
240810,Rn-Natal,202503,161969,67104,42643,271716,785.368,"34,60%","20,62%"
240820,Rn-Nisia Floresta,202503,12701,5212,3438,21351,33.949,"62,89%","37,41%"
240830,Rn-Nova Cruz,202503,15775,4844,3632,24251,35.534,"68,25%","44,39%"
240840,Rn-Olho D Agua do Borges,202503,1623,565,736,2924,3.748,"78,01%","43,30%"
240850,Rn-Ouro Branco,202503,1631,974,1398,4003,5.071,"78,94%","32,16%"
240860,Rn-Parana,202503,2419,532,938,3889,4.046,"96,12%","59,79%"
240870,Rn-Parau,202503,1449,640,705,2794,3.659,"76,36%","39,60%"
240880,Rn-Parazinho,202503,2580,1129,744,4453,4.940,"90,14%","52,23%"
240890,Rn-Parelhas,202503,7330,3801,3841,14972,22.179,"67,51%","33,05%"
240895,Rn-Rio do Fogo,202503,6435,1816,1214,9465,10.672,"88,69%","60,30%"
240910,Rn-Passa e Fica,202503,5683,2159,1747,9589,11.406,"84,07%","49,82%"
240920,Rn-Passagem,202503,1606,527,532,2665,3.222,"82,71%","49,84%"
240930,Rn-Patu,202503,4949,1579,1943,8471,11.245,"75,33%","44,01%"
240933,Rn-Santa Maria,202503,2743,737,472,3952,4.992,"79,17%","54,95%"
240940,Rn-Pau dos Ferros,202503,9436,4353,5003,18792,31.975,"58,77%","29,51%"
240950,Rn-Pedra Grande,202503,1886,846,684,3416,3.729,"91,61%","50,58%"
240960,Rn-Pedra Preta,202503,1230,375,430,2035,2.499,"81,43%","49,22%"
240970,Rn-Pedro Avelino,202503,2929,796,1082,4807,6.345,"75,76%","46,16%"
240980,Rn-Pedro Velho,202503,7784,1557,1312,10653,14.197,"75,04%","54,83%"
240990,Rn-Pendencias,202503,4530,1917,1557,8004,12.536,"63,85%","36,14%"
241000,Rn-Piloes,202503,1712,394,619,2725,3.010,"90,53%","56,88%"
241010,Rn-Poco Branco,202503,5943,2003,1421,9367,12.619,"74,23%","47,10%"
241020,Rn-Portalegre,202503,2921,1436,1399,5756,7.842,"73,40%","37,25%"
241025,Rn-Porto do Mangue,202503,2598,960,818,4376,5.357,"81,69%","48,50%"
241030,Rn-Serra Caiada,202503,4972,1706,1706,8384,11.146,"75,22%","44,61%"
241040,Rn-Pureza,202503,4666,1576,1232,7474,9.707,"77,00%","48,07%"
241050,Rn-Rafael Fernandes,202503,2254,875,975,4104,5.647,"72,68%","39,91%"
241060,Rn-Rafael Godeiro,202503,1185,637,614,2436,3.008,"80,98%","39,39%"
241070,Rn-Riacho da Cruz,202503,1215,449,489,2153,2.741,"78,55%","44,33%"
241080,Rn-Riacho de Santana,202503,1680,795,770,3245,4.243,"76,48%","39,59%"
241090,Rn-Riachuelo,202503,3472,1368,1259,6099,7.627,"79,97%","45,52%"
241100,Rn-Rodolfo Fernandes,202503,1725,846,897,3468,4.349,"79,74%","39,66%"
241105,Rn-Tibau,202503,1894,1272,813,3979,5.674,"70,13%","33,38%"
241110,Rn-Ruy Barbosa,202503,1204,613,571,2388,3.266,"73,12%","36,86%"
241120,Rn-Santa Cruz,202503,14208,5239,3858,23305,38.996,"59,76%","36,43%"
241140,Rn-Santana do Matos,202503,4652,1828,2472,8952,12.746,"70,23%","36,50%"
241142,Rn-Santana do Serido,202503,780,679,641,2100,2.787,"75,35%","27,99%"
241150,Rn-Santo Antonio,202503,10675,2991,2397,16063,22.779,"70,52%","46,86%"
241160,Rn-Sao Bento do Norte,202503,1162,986,1119,3267,3.426,"95,36%","33,92%"
241170,Rn-Sao Bento do Trairi,202503,2194,524,703,3421,3.892,"87,90%","56,37%"
241180,Rn-Sao Fernando,202503,1200,776,643,2619,3.600,"72,75%","33,33%"
241190,Rn-Sao Francisco do Oeste,202503,1569,751,874,3194,4.304,"74,21%","36,45%"
241200,Rn-Sao Goncalo do Amarante,202503,39926,16547,11491,67964,123.207,"55,16%","32,41%"
241210,Rn-Sao Joao do Sabugi,202503,2158,860,1353,4371,6.130,"71,31%","35,20%"
241220,Rn-Sao Jose de Mipibu,202503,17734,7721,4701,30156,49.693,"60,68%","35,69%"
241230,Rn-Sao Jose do Campestre,202503,5275,1339,1280,7894,11.340,"69,61%","46,52%"
241240,Rn-Sao Jose do Serido,202503,1099,1199,1574,3872,4.716,"82,10%","23,30%"
241250,Rn-Sao Miguel,202503,10785,3390,3571,17746,24.329,"72,94%","44,33%"
241255,Rn-Sao Miguel de Touros,202503,4681,2479,1785,8945,10.590,"84,47%","44,20%"
241260,Rn-Sao Paulo do Potengi,202503,7221,2907,2267,12395,17.320,"71,56%","41,69%"
241270,Rn-Sao Pedro,202503,2766,1016,799,4581,5.905,"77,58%","46,84%"
241280,Rn-Sao Rafael,202503,4327,676,1083,6086,7.899,"77,05%","54,78%"
241290,Rn-Sao Tome,202503,4226,1653,1942,7821,10.188,"76,77%","41,48%"
241300,Rn-Sao Vicente,202503,2324,1101,890,4315,6.514,"66,24%","35,68%"
241310,Rn-Senador Eloi de Souza,202503,3698,671,686,5055,6.007,"84,15%","61,56%"
241320,Rn-Senador Georgino Avelino,202503,1634,898,505,3037,4.193,"72,43%","38,97%"
241330,Rn-Serra de Sao Bento,202503,3227,589,549,4365,5.864,"74,44%","55,03%"
241335,Rn-Serra do Mel,202503,6994,2402,2037,11433,13.694,"83,49%","51,07%"
241340,Rn-Serra Negra do Norte,202503,2234,1196,1126,4556,7.801,"58,40%","28,64%"
241350,Rn-Serrinha,202503,3701,1154,926,5781,6.609,"87,47%","56,00%"
241355,Rn-Serrinha dos Pintos,202503,2243,763,879,3885,4.802,"80,90%","46,71%"
241360,Rn-Severiano Melo,202503,2737,1105,1639,5481,5.623,"97,47%","48,68%"
241370,Rn-Sitio Novo,202503,2192,804,886,3882,4.758,"81,59%","46,07%"
241380,Rn-Taboleiro Grande,202503,1204,325,512,2041,2.406,"84,83%","50,04%"
241390,Rn-Taipu,202503,5260,1698,1131,8089,11.716,"69,04%","44,90%"
241400,Rn-Tangara,202503,6660,2071,1472,10203,13.602,"75,01%","48,96%"
241410,Rn-Tenente Ananias,202503,4685,1742,1646,8073,10.587,"76,25%","44,25%"
241415,Rn-Tenente Laurentino Cruz,202503,3071,1157,1075,5303,6.118,"86,68%","50,20%"
241420,Rn-Tibau do Sul,202503,6157,2642,1316,10115,17.840,"56,70%","34,51%"
241430,Rn-Timbauba dos Batistas,202503,768,361,573,1702,2.420,"70,33%","31,74%"
241440,Rn-Touros,202503,18065,5300,2749,26114,34.624,"75,42%","52,17%"
241445,Rn-Triunfo Potiguar,202503,2246,495,520,3261,3.474,"93,87%","64,65%"
241450,Rn-Umarizal,202503,4585,1237,1794,7616,10.671,"71,37%","42,97%"
241460,Rn-Upanema,202503,5180,2600,3377,11157,14.013,"79,62%","36,97%"
241470,Rn-Varzea,202503,2643,565,671,3879,5.383,"72,06%","49,10%"
241475,Rn-Venha-Ver,202503,1709,752,796,3257,3.035,"107,31%","56,31%"
241480,Rn-Vera Cruz,202503,5609,2513,1870,9992,11.044,"90,47%","50,79%"
241490,Rn-Vicosa,202503,946,342,547,1835,1.890,"97,09%","50,05%"
241500,Rn-Vila Flor,202503,1448,648,245,2341,3.289,"71,18%","44,03%"
250010,Pb-Agua Branca,202503,4673,1493,1870,8036,9.578,"83,90%","48,79%"
250020,Pb-Aguiar,202503,2392,782,1307,4481,5.061,"88,54%","47,26%"
250030,Pb-Alagoa Grande,202503,13220,3786,3121,20127,26.774,"75,17%","49,38%"
250040,Pb-Alagoa Nova,202503,8724,3821,2592,15137,21.724,"69,68%","40,16%"
250050,Pb-Alagoinha,202503,7481,1539,1390,10410,14.118,"73,74%","52,99%"
250053,Pb-Alcantil,202503,2517,927,566,4010,5.777,"69,41%","43,57%"
250057,Pb-Algodao de Jandaira,202503,1868,380,261,2509,3.105,"80,81%","60,16%"
250060,Pb-Alhandra,202503,9581,3739,2979,16299,22.797,"71,50%","42,03%"
250070,Pb-Sao Joao do Rio do Peixe,202503,6436,2867,2422,11725,18.468,"63,49%","34,85%"
250073,Pb-Amparo,202503,1357,373,541,2271,2.316,"98,06%","58,59%"
250077,Pb-Aparecida,202503,4319,897,1532,6748,8.225,"82,04%","52,51%"
250080,Pb-Aracagi,202503,10402,1449,1931,13782,17.012,"81,01%","61,15%"
250090,Pb-Arara,202503,5903,991,1224,8118,12.496,"64,96%","47,24%"
250100,Pb-Araruna,202503,7633,2348,1554,11535,17.442,"66,13%","43,76%"
250110,Pb-Areia,202503,9342,3252,1717,14311,23.082,"62,00%","40,47%"
250115,Pb-Areia de Baraunas,202503,1081,256,384,1721,2.036,"84,53%","53,09%"
250120,Pb-Areial,202503,3965,1100,614,5679,7.393,"76,82%","53,63%"
250130,Pb-Aroeiras,202503,10318,2270,2233,14821,19.148,"77,40%","53,89%"
250135,Pb-Assuncao,202503,2668,620,564,3852,4.342,"88,71%","61,45%"
250140,Pb-Baia da Traicao,202503,5286,1518,876,7680,9.648,"79,60%","54,79%"
250150,Pb-Bananeiras,202503,9630,3654,1963,15247,23.989,"63,56%","40,14%"
250153,Pb-Barauna,202503,2434,863,688,3985,4.968,"80,21%","48,99%"
250157,Pb-Barra de Santana,202503,4108,1014,923,6045,8.253,"73,25%","49,78%"
250160,Pb-Barra de Santa Rosa,202503,6369,1513,1664,9546,13.094,"72,90%","48,64%"
250170,Pb-Barra de Sao Miguel,202503,3142,1080,654,4876,6.101,"79,92%","51,50%"
250180,Pb-Bayeux,202503,32709,13724,10392,56825,84.404,"67,33%","38,75%"
250190,Pb-Belem,202503,6913,2701,1828,11442,16.740,"68,35%","41,30%"
250200,Pb-Belem do Brejo do Cruz,202503,3985,657,856,5498,6.324,"86,94%","63,01%"
250205,Pb-Bernardino Batista,202503,1672,608,560,2840,3.650,"77,81%","45,81%"
250210,Pb-Boa Ventura,202503,2867,715,721,4303,5.277,"81,54%","54,33%"
250215,Pb-Boa Vista,202503,1976,1380,1091,4447,6.575,"67,63%","30,05%"
250220,Pb-Bom Jesus,202503,1178,383,501,2062,2.333,"88,38%","50,49%"
250230,Pb-Bom Sucesso,202503,2064,673,946,3683,4.740,"77,70%","43,54%"
250240,Pb-Bonito de Santa Fe,202503,5555,1266,1218,8039,10.460,"76,85%","53,11%"
250250,Pb-Boqueirao,202503,9655,2090,1716,13461,18.153,"74,15%","53,19%"
250260,Pb-Igaracy,202503,2711,1164,952,4827,5.743,"84,05%","47,21%"
250270,Pb-Borborema,202503,2235,995,423,3653,4.231,"86,34%","52,82%"
250280,Pb-Brejo do Cruz,202503,6881,2010,1294,10185,14.050,"72,49%","48,98%"
250290,Pb-Brejo dos Santos,202503,3166,684,923,4773,5.840,"81,73%","54,21%"
250300,Pb-Caapora,202503,9696,2926,2262,14884,21.865,"68,07%","44,34%"
250310,Pb-Cabaceiras,202503,2210,914,1158,4282,5.515,"77,64%","40,07%"
250320,Pb-Cabedelo,202503,21134,5468,4613,31215,70.067,"44,55%","30,16%"
250330,Pb-Cachoeira dos Indios,202503,4492,1210,1480,7182,9.351,"76,80%","48,04%"
250340,Pb-Cacimba de Areia,202503,2324,357,537,3218,3.354,"95,95%","69,29%"
250350,Pb-Cacimba de Dentro,202503,7668,2395,2013,12076,16.373,"73,76%","46,83%"
250355,Pb-Cacimbas,202503,5089,543,694,6326,7.478,"84,59%","68,05%"
250360,Pb-Caicara,202503,3271,914,531,4716,6.713,"70,25%","48,73%"
250370,Pb-Cajazeiras,202503,27964,6103,6213,40280,66.171,"60,87%","42,26%"
250375,Pb-Cajazeirinhas,202503,2380,326,493,3199,2.776,"115,24%","85,73%"
250380,Pb-Caldas Brandao,202503,3254,746,514,4514,5.928,"76,15%","54,89%"
250390,Pb-Camalau,202503,3508,762,1037,5307,6.298,"84,26%","55,70%"
250400,Pb-Campina Grande,202503,85639,64168,50260,200067,440.939,"45,37%","19,42%"
250403,Pb-Capim,202503,4030,1139,788,5957,7.347,"81,08%","54,85%"
250407,Pb-Caraubas,202503,2287,490,912,3689,4.059,"90,88%","56,34%"
250410,Pb-Carrapateira,202503,1271,365,364,2000,2.367,"84,50%","53,70%"
250415,Pb-Casserengue,202503,4032,755,680,5467,7.056,"77,48%","57,14%"
250420,Pb-Catingueira,202503,2360,576,436,3372,4.572,"73,75%","51,62%"
250430,Pb-Catole do Rocha,202503,11281,3584,3729,18594,32.118,"57,89%","35,12%"
250435,Pb-Caturite,202503,2796,1127,1048,4971,5.492,"90,51%","50,91%"
250440,Pb-Conceicao,202503,9267,1946,1711,12924,18.723,"69,03%","49,50%"
250450,Pb-Condado,202503,3113,781,803,4697,6.624,"70,91%","47,00%"
250460,Pb-Conde,202503,13275,5685,3568,22528,29.543,"76,25%","44,93%"
250470,Pb-Congo,202503,2954,770,901,4625,5.102,"90,65%","57,90%"
250480,Pb-Coremas,202503,8026,1633,1640,11299,15.005,"75,30%","53,49%"
250485,Pb-Coxixola,202503,933,315,412,1660,1.882,"88,20%","49,57%"
250490,Pb-Cruz do Espirito Santo,202503,8832,2411,1714,12957,17.718,"73,13%","49,85%"
250500,Pb-Cubati,202503,3826,1220,996,6042,7.820,"77,26%","48,93%"
250510,Pb-Cuite,202503,9111,2459,2108,13678,20.205,"67,70%","45,09%"
250520,Pb-Cuitegi,202503,3386,1106,839,5331,6.894,"77,33%","49,12%"
250523,Pb-Cuite de Mamanguape,202503,3350,1061,691,5102,6.431,"79,33%","52,09%"
250527,Pb-Curral de Cima,202503,3764,414,365,4543,5.406,"84,04%","69,63%"
250530,Pb-Curral Velho,202503,1132,357,263,1752,2.327,"75,29%","48,65%"
250535,Pb-Damiao,202503,3070,602,677,4349,5.131,"84,76%","59,83%"
250540,Pb-Desterro,202503,5015,811,875,6701,8.300,"80,73%","60,42%"
250550,Pb-Vista Serrana,202503,1600,768,561,2929,3.759,"77,92%","42,56%"
250560,Pb-Diamante,202503,3106,1071,878,5055,6.431,"78,60%","48,30%"
250570,Pb-Dona Ines,202503,5729,1660,1257,8646,10.640,"81,26%","53,84%"
250580,Pb-Duas Estradas,202503,1759,513,323,2595,3.377,"76,84%","52,09%"
250590,Pb-Emas,202503,1856,390,272,2518,3.053,"82,48%","60,79%"
250600,Pb-Esperanca,202503,12800,5224,3721,21745,32.522,"66,86%","39,36%"
250610,Pb-Fagundes,202503,5511,1680,1190,8381,11.315,"74,07%","48,71%"
250620,Pb-Frei Martinho,202503,1481,381,455,2317,2.913,"79,54%","50,84%"
250625,Pb-Gado Bravo,202503,5163,1115,822,7100,8.395,"84,57%","61,50%"
250630,Pb-Guarabira,202503,19954,7032,5926,32912,59.836,"55,00%","33,35%"
250640,Pb-Gurinhem,202503,6603,2065,1581,10249,14.133,"72,52%","46,72%"
250650,Pb-Gurjao,202503,1585,547,560,2692,3.343,"80,53%","47,41%"
250660,Pb-Ibiara,202503,2436,840,925,4201,5.733,"73,28%","42,49%"
250670,Pb-Imaculada,202503,5246,1282,1141,7669,10.550,"72,69%","49,73%"
250680,Pb-Inga,202503,9879,1991,1758,13628,18.197,"74,89%","54,29%"
250690,Pb-Itabaiana,202503,10731,2795,2784,16310,23.621,"69,05%","45,43%"
250700,Pb-Itaporanga,202503,8491,3374,2573,14438,24.686,"58,49%","34,40%"
250710,Pb-Itapororoca,202503,8452,3173,1888,13513,19.054,"70,92%","44,36%"
250720,Pb-Itatuba,202503,5344,1686,1279,8309,10.816,"76,82%","49,41%"
250730,Pb-Jacarau,202503,8526,1766,1551,11843,14.923,"79,36%","57,13%"
250740,Pb-Jerico,202503,3162,1061,1046,5269,7.721,"68,24%","40,95%"
250750,Pb-Joao Pessoa,202503,197741,80838,63651,342230,888.679,"38,51%","22,25%"
250760,Pb-Juarez Tavora,202503,5053,646,895,6594,8.057,"81,84%","62,72%"
250770,Pb-Juazeirinho,202503,7839,3140,1724,12703,17.488,"72,64%","44,83%"
250780,Pb-Junco do Serido,202503,3294,1007,840,5141,7.002,"73,42%","47,04%"
250790,Pb-Juripiranga,202503,4694,1758,1176,7628,10.259,"74,35%","45,75%"
250800,Pb-Juru,202503,4241,1159,1283,6683,9.410,"71,02%","45,07%"
250810,Pb-Lagoa,202503,2262,646,749,3657,4.502,"81,23%","50,24%"
250820,Pb-Lagoa de Dentro,202503,3977,901,494,5372,8.088,"66,42%","49,17%"
250830,Pb-Lagoa Seca,202503,10674,4817,3787,19278,29.053,"66,35%","36,74%"
250840,Pb-Lastro,202503,1575,574,383,2532,3.292,"76,91%","47,84%"
250850,Pb-Livramento,202503,3569,1038,798,5405,7.045,"76,72%","50,66%"
250855,Pb-Logradouro,202503,2537,524,398,3459,5.045,"68,56%","50,29%"
250860,Pb-Lucena,202503,5556,3299,2379,11234,13.019,"86,29%","42,68%"
250870,Pb-Mae D Agua,202503,1705,539,693,2937,3.624,"81,04%","47,05%"
250880,Pb-Malta,202503,2628,844,706,4178,6.259,"66,75%","41,99%"
250890,Pb-Mamanguape,202503,18939,6026,4186,29151,46.719,"62,40%","40,54%"
250900,Pb-Manaira,202503,5903,1373,1696,8972,10.700,"83,85%","55,17%"
250905,Pb-Marcacao,202503,5538,1216,682,7436,9.435,"78,81%","58,70%"
250910,Pb-Mari,202503,12161,2178,1896,16235,22.126,"73,38%","54,96%"
250915,Pb-Marizopolis,202503,3658,797,1780,6235,6.960,"89,58%","52,56%"
250920,Pb-Massaranduba,202503,6287,2056,1314,9657,14.666,"65,85%","42,87%"
250930,Pb-Mataraca,202503,4184,1590,961,6735,8.585,"78,45%","48,74%"
250933,Pb-Matinhas,202503,2330,882,671,3883,4.735,"82,01%","49,21%"
250937,Pb-Mato Grosso,202503,1317,569,389,2275,2.592,"87,77%","50,81%"
250939,Pb-Matureia,202503,3808,817,850,5475,6.677,"82,00%","57,03%"
250940,Pb-Mogeiro,202503,7119,1959,1754,10832,14.375,"75,35%","49,52%"
250950,Pb-Montadas,202503,3068,954,701,4723,6.083,"77,64%","50,44%"
250960,Pb-Monte Horebe,202503,2308,691,534,3533,4.435,"79,66%","52,04%"
250970,Pb-Monteiro,202503,15698,4676,5436,25810,33.742,"76,49%","46,52%"
250980,Pb-Mulungu,202503,4565,1025,644,6234,8.945,"69,69%","51,03%"
250990,Pb-Natuba,202503,3970,1602,1071,6643,9.014,"73,70%","44,04%"
251000,Pb-Nazarezinho,202503,3833,1018,1139,5990,7.392,"81,03%","51,85%"
251010,Pb-Nova Floresta,202503,4919,1381,1071,7371,9.884,"74,58%","49,77%"
251020,Pb-Nova Olinda,202503,3126,691,626,4443,5.909,"75,19%","52,90%"
251030,Pb-Nova Palmeira,202503,1600,657,597,2854,4.362,"65,43%","36,68%"
251040,Pb-Olho D Agua,202503,3399,815,731,4945,6.111,"80,92%","55,62%"
251050,Pb-Olivedos,202503,1492,806,676,2974,3.674,"80,95%","40,61%"
251060,Pb-Ouro Velho,202503,1380,574,820,2774,2.998,"92,53%","46,03%"
251065,Pb-Parari,202503,673,329,509,1511,1.751,"86,29%","38,44%"
251070,Pb-Passagem,202503,1277,370,435,2082,2.562,"81,26%","49,84%"
251080,Pb-Patos,202503,32424,12675,11268,56367,107.774,"52,30%","30,09%"
251090,Pb-Paulista,202503,5869,1317,1243,8429,12.160,"69,32%","48,26%"
251100,Pb-Pedra Branca,202503,1486,734,511,2731,3.846,"71,01%","38,64%"
251110,Pb-Pedra Lavrada,202503,3001,938,1345,5284,6.998,"75,51%","42,88%"
251120,Pb-Pedras de Fogo,202503,13724,5151,3663,22538,31.152,"72,35%","44,05%"
251130,Pb-Pianco,202503,7913,1095,1165,10173,17.006,"59,82%","46,53%"
251140,Pb-Picui,202503,7884,2763,1759,12406,18.835,"65,87%","41,86%"
251150,Pb-Pilar,202503,5473,2016,1024,8513,12.801,"66,50%","42,75%"
251160,Pb-Piloes,202503,4801,1052,762,6615,6.979,"94,78%","68,79%"
251170,Pb-Piloezinhos,202503,3594,546,542,4682,5.514,"84,91%","65,18%"
251180,Pb-Pirpirituba,202503,4431,1740,1377,7548,9.467,"79,73%","46,80%"
251190,Pb-Pitimbu,202503,9443,2149,1642,13234,17.164,"77,10%","55,02%"
251200,Pb-Pocinhos,202503,9468,2178,1760,13406,17.990,"74,52%","52,63%"
251203,Pb-Poco Dantas,202503,1828,885,862,3575,3.932,"90,92%","46,49%"
251207,Pb-Poco de Jose de Moura,202503,1672,643,933,3248,4.120,"78,83%","40,58%"
251210,Pb-Pombal,202503,12143,4663,4878,21684,33.796,"64,16%","35,93%"
251220,Pb-Prata,202503,1917,659,825,3401,4.027,"84,45%","47,60%"
251230,Pb-Princesa Isabel,202503,8824,2951,2724,14499,21.659,"66,94%","40,74%"
251240,Pb-Puxinana,202503,6039,2636,2240,10915,14.837,"73,57%","40,70%"
251250,Pb-Queimadas,202503,19024,7949,6380,33353,50.214,"66,42%","37,89%"
251260,Pb-Quixaba,202503,900,334,244,1478,1.798,"82,20%","50,06%"
251270,Pb-Remigio,202503,9225,2625,1768,13618,18.373,"74,12%","50,21%"
251272,Pb-Pedro Regio,202503,3025,509,332,3866,5.925,"65,25%","51,05%"
251274,Pb-Riachao,202503,1526,514,529,2569,2.964,"86,67%","51,48%"
251275,Pb-Riachao do Bacamarte,202503,2416,729,851,3996,4.877,"81,94%","49,54%"
251276,Pb-Riachao do Poco,202503,2443,927,555,3925,4.946,"79,36%","49,39%"
251278,Pb-Riacho de Santo Antonio,202503,1101,426,452,1979,2.044,"96,82%","53,86%"
251280,Pb-Riacho dos Cavalos,202503,4743,1146,779,6668,8.762,"76,10%","54,13%"
251290,Pb-Rio Tinto,202503,10688,3132,2485,16305,25.394,"64,21%","42,09%"
251300,Pb-Salgadinho,202503,1558,378,145,2081,3.437,"60,55%","45,33%"
251310,Pb-Salgado de Sao Felix,202503,5131,1777,1391,8299,11.760,"70,57%","43,63%"
251315,Pb-Santa Cecilia,202503,4161,1279,936,6376,8.031,"79,39%","51,81%"
251320,Pb-Santa Cruz,202503,2430,982,1084,4496,6.041,"74,42%","40,23%"
251330,Pb-Santa Helena,202503,3493,629,1055,5177,6.020,"86,00%","58,02%"
251335,Pb-Santa Ines,202503,2338,378,309,3025,3.274,"92,39%","71,41%"
251340,Pb-Santa Luzia,202503,5643,2122,2177,9942,15.387,"64,61%","36,67%"
251350,Pb-Santana de Mangueira,202503,2251,616,453,3320,5.106,"65,02%","44,09%"
251360,Pb-Santana dos Garrotes,202503,3028,942,1215,5185,6.657,"77,89%","45,49%"
251365,Pb-Santarem,202503,1113,397,787,2297,2.606,"88,14%","42,71%"
251370,Pb-Santa Rita,202503,45466,20978,14311,80755,159.121,"50,75%","28,57%"
251380,Pb-Santa Teresinha,202503,2391,546,703,3640,4.499,"80,91%","53,15%"
251385,Pb-Santo Andre,202503,1149,506,585,2240,2.702,"82,90%","42,52%"
251390,Pb-Sao Bento,202503,14186,4352,2943,21481,33.700,"63,74%","42,09%"
251392,Pb-Sao Bentinho,202503,1960,592,619,3171,4.473,"70,89%","43,82%"
251394,Pb-Sao Domingos do Cariri,202503,1150,555,456,2161,2.676,"80,75%","42,97%"
251396,Pb-Sao Domingos de Pombal,202503,1160,483,488,2131,2.636,"80,84%","44,01%"
251398,Pb-Sao Francisco,202503,1363,630,969,2962,3.190,"92,85%","42,73%"
251400,Pb-Sao Joao do Cariri,202503,2004,593,826,3423,4.341,"78,85%","46,16%"
251410,Pb-Sao Joao do Tigre,202503,2278,579,804,3661,4.363,"83,91%","52,21%"
251420,Pb-Sao Jose da Lagoa Tapada,202503,3873,912,982,5767,7.270,"79,33%","53,27%"
251430,Pb-Sao Jose de Caiana,202503,3416,686,632,4734,5.032,"94,08%","67,89%"
251440,Pb-Sao Jose de Espinharas,202503,1897,615,642,3154,4.099,"76,95%","46,28%"
251445,Pb-Sao Jose dos Ramos,202503,2930,995,624,4549,6.105,"74,51%","47,99%"
251450,Pb-Sao Jose de Piranhas,202503,8993,2331,2100,13424,19.552,"68,66%","46,00%"
251455,Pb-Sao Jose de Princesa,202503,1872,439,359,2670,3.383,"78,92%","55,34%"
251460,Pb-Sao Jose do Bonfim,202503,1738,634,767,3139,3.333,"94,18%","52,15%"
251465,Pb-Sao Jose do Brejo do Cruz,202503,755,408,271,1434,1.748,"82,04%","43,19%"
251470,Pb-Sao Jose do Sabugi,202503,1611,964,966,3541,4.270,"82,93%","37,73%"
251480,Pb-Sao Jose dos Cordeiros,202503,1667,632,856,3155,3.474,"90,82%","47,99%"
251490,Pb-Sao Mamede,202503,3373,976,877,5226,7.640,"68,40%","44,15%"
251500,Pb-Sao Miguel de Taipu,202503,3723,1215,678,5616,7.287,"77,07%","51,09%"
251510,Pb-Sao Sebastiao de Lagoa de Roca,202503,4120,2412,1781,8313,11.365,"73,15%","36,25%"
251520,Pb-Sao Sebastiao do Umbuzeiro,202503,1572,634,718,2924,3.376,"86,61%","46,56%"
251530,Pb-Sape,202503,24878,6613,5709,37200,53.309,"69,78%","46,67%"
251540,Pb-Serido,202503,6150,1663,1644,9457,10.620,"89,05%","57,91%"
251550,Pb-Serra Branca,202503,6714,1180,1950,9844,14.075,"69,94%","47,70%"
251560,Pb-Serra da Raiz,202503,1137,483,244,1864,3.162,"58,95%","35,96%"
251570,Pb-Serra Grande,202503,1589,495,587,2671,3.043,"87,78%","52,22%"
251580,Pb-Serra Redonda,202503,3482,874,946,5302,6.984,"75,92%","49,86%"
251590,Pb-Serraria,202503,2615,587,597,3799,4.839,"78,51%","54,04%"
251593,Pb-Sertaozinho,202503,1891,835,419,3145,5.282,"59,54%","35,80%"
251597,Pb-Sobrado,202503,4787,918,643,6348,8.579,"73,99%","55,80%"
251600,Pb-Solanea,202503,12363,3623,2444,18430,27.749,"66,42%","44,55%"
251610,Pb-Soledade,202503,6026,2205,2148,10379,14.381,"72,17%","41,90%"
251615,Pb-Sossego,202503,2172,531,719,3422,3.461,"98,87%","62,76%"
251620,Pb-Sousa,202503,29613,7866,7906,45385,69.876,"64,95%","42,38%"
251630,Pb-Sume,202503,7722,2162,2524,12408,17.763,"69,85%","43,47%"
251640,Pb-Campo de Santana,202503,4217,987,740,5944,7.934,"74,92%","53,15%"
251650,Pb-Taperoa,202503,7569,1855,1887,11311,14.376,"78,68%","52,65%"
251660,Pb-Tavares,202503,7325,1870,2391,11586,14.464,"80,10%","50,64%"
251670,Pb-Teixeira,202503,8562,1778,1471,11811,15.082,"78,31%","56,77%"
251675,Pb-Tenorio,202503,1815,290,315,2420,3.069,"78,85%","59,14%"
251680,Pb-Triunfo,202503,4336,1165,1124,6625,10.259,"64,58%","42,27%"
251690,Pb-Uirauna,202503,6006,1658,2355,10019,15.386,"65,12%","39,04%"
251700,Pb-Umbuzeiro,202503,4222,1440,1334,6996,9.302,"75,21%","45,39%"
251710,Pb-Varzea,202503,961,440,595,1996,2.764,"72,21%","34,77%"
251720,Pb-Vieiropolis,202503,2038,930,843,3811,4.974,"76,62%","40,97%"
251740,Pb-Zabele,202503,1240,367,506,2113,2.310,"91,47%","53,68%"
260005,Pe-Abreu e Lima,202503,39171,13542,12874,65587,103.945,"63,10%","37,68%"
260010,Pe-Afogados da Ingazeira,202503,15077,7628,5872,28577,42.407,"67,39%","35,55%"
260020,Pe-Afranio,202503,9111,2957,3258,15326,19.349,"79,21%","47,09%"
260030,Pe-Agrestina,202503,13263,2680,3084,19027,24.615,"77,30%","53,88%"
260040,Pe-Agua Preta,202503,11943,3768,3209,18920,27.221,"69,51%","43,87%"
260050,Pe-Aguas Belas,202503,28141,3653,2839,34633,43.713,"79,23%","64,38%"
260060,Pe-Alagoinha,202503,6858,1717,1664,10239,14.355,"71,33%","47,77%"
260070,Pe-Alianca,202503,17661,4754,4451,26866,37.372,"71,89%","47,26%"
260080,Pe-Altinho,202503,10695,2250,2080,15025,21.185,"70,92%","50,48%"
260090,Pe-Amaraji,202503,9554,2341,2055,13950,18.471,"75,52%","51,72%"
260100,Pe-Angelim,202503,5786,1185,1158,8129,10.580,"76,83%","54,69%"
260105,Pe-Aracoiaba,202503,9396,2639,1893,13928,19.936,"69,86%","47,13%"
260110,Pe-Araripina,202503,43032,13349,8634,65015,90.104,"72,16%","47,76%"
260120,Pe-Arcoverde,202503,28540,8048,5936,42524,82.003,"51,86%","34,80%"
260130,Pe-Barra de Guabiraba,202503,5270,1890,1212,8372,12.616,"66,36%","41,77%"
260140,Pe-Barreiros,202503,18823,5231,4377,28431,42.056,"67,60%","44,76%"
260150,Pe-Belem de Maria,202503,5771,1165,956,7892,10.829,"72,88%","53,29%"
260160,Pe-Belem de Sao Francisco,202503,12678,1758,1772,16208,18.713,"86,61%","67,75%"
260170,Pe-Belo Jardim,202503,31867,10475,8000,50342,83.647,"60,18%","38,10%"
260180,Pe-Betania,202503,6239,1893,1620,9752,11.981,"81,40%","52,07%"
260190,Pe-Bezerros,202503,28553,5208,6762,40523,64.809,"62,53%","44,06%"
260200,Pe-Bodoco,202503,19795,3813,3532,27140,36.129,"75,12%","54,79%"
260210,Pe-Bom Conselho,202503,21584,5932,4405,31921,46.192,"69,11%","46,73%"
260220,Pe-Bom Jardim,202503,19466,3549,2808,25823,39.278,"65,74%","49,56%"
260230,Pe-Bonito,202503,20924,4329,3981,29234,39.163,"74,65%","53,43%"
260240,Pe-Brejao,202503,5399,1600,1248,8247,9.399,"87,74%","57,44%"
260250,Pe-Brejinho,202503,3947,1177,1121,6245,8.010,"77,97%","49,28%"
260260,Pe-Brejo da Madre de Deus,202503,26344,7172,4793,38309,51.107,"74,96%","51,55%"
260270,Pe-Buenos Aires,202503,7606,1695,1474,10775,13.254,"81,30%","57,39%"
260280,Pe-Buique,202503,28292,5422,3947,37661,54.425,"69,20%","51,98%"
260290,Pe-Cabo de Santo Agostinho,202503,71161,28552,23006,122719,216.969,"56,56%","32,80%"
260300,Pe-Cabrobo,202503,18829,4518,4166,27513,31.746,"86,67%","59,31%"
260310,Pe-Cachoeirinha,202503,11255,2419,2172,15846,20.612,"76,88%","54,60%"
260320,Pe-Caetes,202503,15006,3786,3432,22224,30.441,"73,01%","49,30%"
260330,Pe-Calcado,202503,4956,1320,1085,7361,11.445,"64,32%","43,30%"
260340,Pe-Calumbi,202503,3793,1032,909,5734,5.367,"106,84%","70,67%"
260345,Pe-Camaragibe,202503,47807,18899,14671,81377,155.771,"52,24%","30,69%"
260350,Pe-Camocim de Sao Felix,202503,10333,1534,1836,13703,17.991,"76,17%","57,43%"
260360,Pe-Camutanga,202503,3771,1264,1053,6088,7.972,"76,37%","47,30%"
260370,Pe-Canhotinho,202503,10751,2789,2666,16206,25.090,"64,59%","42,85%"
260380,Pe-Capoeiras,202503,9934,2940,2408,15282,18.890,"80,90%","52,59%"
260390,Pe-Carnaiba,202503,7544,3587,3930,15061,19.513,"77,18%","38,66%"
260392,Pe-Carnaubeira da Penha,202503,9484,1927,1328,12739,12.682,"100,45%","74,78%"
260400,Pe-Carpina,202503,32309,8809,8077,49195,83.205,"59,13%","38,83%"
260410,Pe-Caruaru,202503,119349,58037,41477,218863,402.290,"54,40%","29,67%"
260415,Pe-Casinhas,202503,8285,1692,2212,12189,13.489,"90,36%","61,42%"
260420,Pe-Catende,202503,17662,3266,3474,24402,33.279,"73,33%","53,07%"
260430,Pe-Cedro,202503,5374,1935,1590,8899,10.845,"82,06%","49,55%"
260440,Pe-Cha de Alegria,202503,6971,1662,1416,10049,13.461,"74,65%","51,79%"
260450,Pe-Cha Grande,202503,10711,2634,1918,15263,21.224,"71,91%","50,47%"
260460,Pe-Condado,202503,9169,4247,3037,16453,25.383,"64,82%","36,12%"
260470,Pe-Correntes,202503,9020,1247,1267,11534,17.660,"65,31%","51,08%"
260480,Pe-Cortes,202503,5632,2007,1718,9357,10.512,"89,01%","53,58%"
260490,Pe-Cumaru,202503,8592,1941,2273,12806,16.252,"78,80%","52,87%"
260500,Pe-Cupira,202503,10104,3653,2709,16466,24.301,"67,76%","41,58%"
260510,Pe-Custodia,202503,19030,3362,4138,26530,39.403,"67,33%","48,30%"
260515,Pe-Dormentes,202503,6381,3374,2946,12701,17.749,"71,56%","35,95%"
260520,Pe-Escada,202503,23332,7707,6074,37113,62.252,"59,62%","37,48%"
260530,Pe-Exu,202503,19554,4482,3664,27700,33.436,"82,84%","58,48%"
260540,Pe-Feira Nova,202503,13008,1657,1792,16457,22.169,"74,23%","58,68%"
260545,Pe-Fernando de Noronha,202503,155,139,181,475,3.316,"14,32%","4,67%"
260550,Pe-Ferreiros,202503,4797,2162,1961,8920,15.794,"56,48%","30,37%"
260560,Pe-Flores,202503,9147,3106,2822,15075,20.835,"72,35%","43,90%"
260570,Pe-Floresta,202503,15735,3543,2826,22104,31.627,"69,89%","49,75%"
260580,Pe-Frei Miguelinho,202503,8924,1318,1144,11386,14.070,"80,92%","63,43%"
260590,Pe-Gameleira,202503,10352,2349,1875,14576,17.973,"81,10%","57,60%"
260600,Pe-Garanhuns,202503,55065,19262,17308,91635,151.064,"60,66%","36,45%"
260610,Pe-Gloria do Goita,202503,15823,3442,3263,22528,30.370,"74,18%","52,10%"
260620,Pe-Goiana,202503,33526,10816,10082,54424,85.160,"63,91%","39,37%"
260630,Pe-Granito,202503,4295,1095,1069,6459,7.206,"89,63%","59,60%"
260640,Pe-Gravata,202503,38688,9453,8805,56946,91.887,"61,97%","42,10%"
260650,Pe-Iati,202503,10702,2270,1902,14874,17.605,"84,49%","60,79%"
260660,Pe-Ibimirim,202503,13267,2728,2993,18988,28.760,"66,02%","46,13%"
260670,Pe-Ibirajuba,202503,3481,1218,1356,6055,7.344,"82,45%","47,40%"
260680,Pe-Igarassu,202503,44700,17380,16152,78232,122.312,"63,96%","36,55%"
260690,Pe-Iguaraci,202503,5536,1584,1859,8979,11.366,"79,00%","48,71%"
260700,Pe-Inaja,202503,16222,1121,1183,18526,27.488,"67,40%","59,01%"
260710,Pe-Ingazeira,202503,2183,755,827,3765,4.959,"75,92%","44,02%"
260720,Pe-Ipojuca,202503,47324,13715,12216,73255,105.638,"69,35%","44,80%"
260730,Pe-Ipubi,202503,17599,3965,2720,24284,30.603,"79,35%","57,51%"
260740,Pe-Itacuruba,202503,2514,612,772,3898,4.490,"86,82%","55,99%"
260750,Pe-Itaiba,202503,15184,2535,2704,20423,33.691,"60,62%","45,07%"
260760,Pe-Itamaraca,202503,11109,2288,2116,15513,25.529,"60,77%","43,52%"
260765,Pe-Itambe,202503,14579,6173,3751,24503,36.626,"66,90%","39,81%"
260770,Pe-Itapetim,202503,6849,1542,1948,10339,14.232,"72,65%","48,12%"
260775,Pe-Itapissuma,202503,10824,3708,2788,17320,29.463,"58,79%","36,74%"
260780,Pe-Itaquitinga,202503,5617,3069,2236,10922,17.109,"63,84%","32,83%"
260790,Pe-Jaboatao dos Guararapes,202503,210104,73159,66469,349732,683.285,"51,18%","30,75%"
260795,Pe-Jaqueira,202503,5466,1333,1161,7960,10.483,"75,93%","52,14%"
260800,Pe-Jatauba,202503,9991,2006,1808,13805,16.323,"84,57%","61,21%"
260805,Pe-Jatoba,202503,6347,1833,1874,10054,14.463,"69,52%","43,88%"
260810,Pe-Joao Alfredo,202503,11393,3833,2846,18072,28.903,"62,53%","39,42%"
260820,Pe-Joaquim Nabuco,202503,8081,1389,1607,11077,13.506,"82,02%","59,83%"
260825,Pe-Jucati,202503,5756,1954,1137,8847,11.975,"73,88%","48,07%"
260830,Pe-Jupi,202503,8222,2706,2012,12940,15.943,"81,16%","51,57%"
260840,Pe-Jurema,202503,8606,1373,1363,11342,14.027,"80,86%","61,35%"
260845,Pe-Lagoa do Carro,202503,7809,2585,2210,12604,18.708,"67,37%","41,74%"
260850,Pe-Lagoa do Itaenga,202503,7600,2921,2292,12813,19.915,"64,34%","38,16%"
260860,Pe-Lagoa do Ouro,202503,6275,2119,1706,10100,12.364,"81,69%","50,75%"
260870,Pe-Lagoa dos Gatos,202503,7745,1325,1214,10284,14.386,"71,49%","53,84%"
260875,Pe-Lagoa Grande,202503,11728,4207,3936,19871,24.952,"79,64%","47,00%"
260880,Pe-Lajedo,202503,20692,5665,4130,30487,41.786,"72,96%","49,52%"
260890,Pe-Limoeiro,202503,18660,9317,6308,34285,59.125,"57,99%","31,56%"
260900,Pe-Macaparana,202503,8737,5239,2283,16259,24.624,"66,03%","35,48%"
260910,Pe-Machados,202503,6282,1620,995,8897,11.471,"77,56%","54,76%"
260915,Pe-Manari,202503,12314,1091,1356,14761,26.773,"55,13%","45,99%"
260920,Pe-Maraial,202503,5329,1261,1122,7712,9.432,"81,76%","56,50%"
260930,Pe-Mirandiba,202503,7591,2672,2193,12456,14.599,"85,32%","52,00%"
260940,Pe-Moreno,202503,23381,7261,6204,36846,57.647,"63,92%","40,56%"
260950,Pe-Nazare da Mata,202503,10167,4919,4166,19252,32.153,"59,88%","31,62%"
260960,Pe-Olinda,202503,121951,41086,38717,201754,365.402,"55,21%","33,37%"
260970,Pe-Orobo,202503,9650,2905,2324,14879,22.438,"66,31%","43,01%"
260980,Pe-Oroco,202503,10448,1641,1508,13597,14.100,"96,43%","74,10%"
260990,Pe-Ouricuri,202503,28924,10775,7341,47040,68.329,"68,84%","42,33%"
261000,Pe-Palmares,202503,24324,7006,6752,38082,56.615,"67,26%","42,96%"
261010,Pe-Palmeirina,202503,4006,756,854,5616,7.154,"78,50%","56,00%"
261020,Pe-Panelas,202503,12033,3261,2698,17992,23.449,"76,73%","51,32%"
261030,Pe-Paranatama,202503,8060,2449,1984,12493,12.712,"98,28%","63,40%"
261040,Pe-Parnamirim,202503,10001,2858,2625,15484,19.028,"81,37%","52,56%"
261050,Pe-Passira,202503,14152,3806,2993,20951,29.719,"70,50%","47,62%"
261060,Pe-Paudalho,202503,27111,7097,5311,39519,59.638,"66,26%","45,46%"
261070,Pe-Paulista,202503,105374,34703,35743,175820,362.960,"48,44%","29,03%"
261080,Pe-Pedra,202503,13622,1600,1689,16911,23.605,"71,64%","57,71%"
261090,Pe-Pesqueira,202503,31348,7358,6411,45117,65.408,"68,98%","47,93%"
261100,Pe-Petrolandia,202503,15798,5334,3662,24794,35.991,"68,89%","43,89%"
261110,Pe-Petrolina,202503,115595,61419,46162,223176,414.083,"53,90%","27,92%"
261120,Pe-Pocao,202503,6780,1386,1551,9717,10.805,"89,93%","62,75%"
261130,Pe-Pombos,202503,12873,2849,2477,18199,26.847,"67,79%","47,95%"
261140,Pe-Primavera,202503,5154,1596,1738,8488,14.351,"59,15%","35,91%"
261150,Pe-Quipapa,202503,9005,2407,1987,13399,17.974,"74,55%","50,10%"
261153,Pe-Quixaba,202503,3258,1486,1374,6118,6.755,"90,57%","48,23%"
261160,Pe-Recife,202503,314468,169002,123799,607269,1.587.707,"38,25%","19,81%"
261170,Pe-Riacho das Almas,202503,13179,2461,2777,18417,21.411,"86,02%","61,55%"
261180,Pe-Ribeirao,202503,14278,4975,4093,23346,34.255,"68,15%","41,68%"
261190,Pe-Rio Formoso,202503,8781,2721,2348,13850,20.460,"67,69%","42,92%"
261200,Pe-Saire,202503,5356,1302,1315,7973,11.218,"71,07%","47,74%"
261210,Pe-Salgadinho,202503,3108,738,710,4556,5.620,"81,07%","55,30%"
261220,Pe-Salgueiro,202503,23322,9824,7503,40649,65.635,"61,93%","35,53%"
261230,Pe-Saloa,202503,7332,2055,1601,10988,14.173,"77,53%","51,73%"
261240,Pe-Sanharo,202503,10875,1844,1862,14581,18.933,"77,01%","57,44%"
261245,Pe-Santa Cruz,202503,6211,2495,2444,11150,14.320,"77,86%","43,37%"
261247,Pe-Santa Cruz da Baixa Verde,202503,5822,2068,1990,9880,11.933,"82,80%","48,79%"
261250,Pe-Santa Cruz do Capibaribe,202503,39812,18353,12205,70370,104.277,"67,48%","38,18%"
261255,Pe-Santa Filomena,202503,6322,2754,2748,11824,12.402,"95,34%","50,98%"
261260,Pe-Santa Maria da Boa Vista,202503,28116,5125,4537,37778,42.682,"88,51%","65,87%"
261270,Pe-Santa Maria do Cambuca,202503,8663,1251,1756,11670,14.533,"80,30%","59,61%"
261280,Pe-Santa Terezinha,202503,4829,1363,1074,7266,10.513,"69,11%","45,93%"
261290,Pe-Sao Benedito do Sul,202503,5468,1015,937,7420,13.479,"55,05%","40,57%"
261300,Pe-Sao Bento do Una,202503,22653,7644,6355,36652,51.264,"71,50%","44,19%"
261310,Pe-Sao Caitano,202503,16540,4858,3941,25339,39.117,"64,78%","42,28%"
261320,Pe-Sao Joao,202503,11585,3248,2535,17368,24.772,"70,11%","46,77%"
261330,Pe-Sao Joaquim do Monte,202503,11343,2049,1863,15255,20.440,"74,63%","55,49%"
261340,Pe-Sao Jose da Coroa Grande,202503,10833,2326,1917,15076,19.468,"77,44%","55,65%"
261350,Pe-Sao Jose do Belmonte,202503,16418,5195,4009,25622,36.752,"69,72%","44,67%"
261360,Pe-Sao Jose do Egito,202503,13704,3450,3120,20274,32.491,"62,40%","42,18%"
261370,Pe-Sao Lourenco da Mata,202503,39520,15297,11843,66660,117.759,"56,61%","33,56%"
261380,Pe-Sao Vicente Ferrer,202503,7813,2901,1947,12661,17.176,"73,71%","45,49%"
261390,Pe-Serra Talhada,202503,30346,14221,11336,55903,98.143,"56,96%","30,92%"
261400,Pe-Serrita,202503,9305,3077,2752,15134,18.759,"80,68%","49,60%"
261410,Pe-Sertania,202503,15497,4115,4616,24228,34.269,"70,70%","45,22%"
261420,Pe-Sirinhaem,202503,16633,4835,3353,24821,39.233,"63,27%","42,40%"
261430,Pe-Moreilandia,202503,7311,1652,1725,10688,10.849,"98,52%","67,39%"
261440,Pe-Solidao,202503,2540,1034,703,4277,5.403,"79,16%","47,01%"
261450,Pe-Surubim,202503,27325,7226,5440,39991,67.515,"59,23%","40,47%"
261460,Pe-Tabira,202503,14131,4431,3707,22269,29.093,"76,54%","48,57%"
261470,Pe-Tacaimbo,202503,6494,1758,1396,9648,14.277,"67,58%","45,49%"
261480,Pe-Tacaratu,202503,9837,4334,2800,16971,24.803,"68,42%","39,66%"
261485,Pe-Tamandare,202503,11256,3801,2946,18003,24.534,"73,38%","45,88%"
261500,Pe-Taquaritinga do Norte,202503,12391,3883,3033,19307,25.497,"75,72%","48,60%"
261510,Pe-Terezinha,202503,3955,849,794,5598,6.857,"81,64%","57,68%"
261520,Pe-Terra Nova,202503,4270,1646,1331,7247,9.221,"78,59%","46,31%"
261530,Pe-Timbauba,202503,17404,11181,7573,36158,47.575,"76,00%","36,58%"
261540,Pe-Toritama,202503,19552,6984,3120,29656,43.636,"67,96%","44,81%"
261550,Pe-Tracunhaem,202503,5801,2314,1657,9772,14.393,"67,89%","40,30%"
261560,Pe-Trindade,202503,18532,4241,3329,26102,32.086,"81,35%","57,76%"
261570,Pe-Triunfo,202503,5599,2783,3151,11533,15.142,"76,17%","36,98%"
261580,Pe-Tupanatinga,202503,14321,2002,2125,18448,27.009,"68,30%","53,02%"
261590,Pe-Tuparetama,202503,4282,1291,1037,6610,8.252,"80,10%","51,89%"
261600,Pe-Venturosa,202503,9624,2303,2010,13937,17.609,"79,15%","54,65%"
261610,Pe-Verdejante,202503,3881,1606,1313,6800,9.474,"71,78%","40,96%"
261618,Pe-Vertente do Lerio,202503,4392,821,896,6109,7.782,"78,50%","56,44%"
261620,Pe-Vertentes,202503,10139,2610,1442,14191,22.955,"61,82%","44,17%"
261630,Pe-Vicencia,202503,9036,5079,3402,17517,27.297,"64,17%","33,10%"
261640,Pe-Vitoria de Santo Antao,202503,51533,18530,16169,86232,143.799,"59,97%","35,84%"
261650,Pe-Xexeu,202503,7837,1237,1388,10462,11.791,"88,73%","66,47%"
270010,Al-Agua Branca,202503,8584,3756,2657,14997,19.550,"76,71%","43,91%"
270020,Al-Anadia,202503,7193,1662,1389,10244,14.193,"72,18%","50,68%"
270030,Al-Arapiraca,202503,67376,24630,17262,109268,243.661,"44,84%","27,65%"
270040,Al-Atalaia,202503,15713,6358,3966,26037,38.530,"67,58%","40,78%"
270050,Al-Barra de Santo Antonio,202503,9804,1603,1424,12831,16.735,"76,67%","58,58%"
270060,Al-Barra de Sao Miguel,202503,3539,1553,1079,6171,8.118,"76,02%","43,59%"
270070,Al-Batalha,202503,10492,1904,1693,14089,17.103,"82,38%","61,35%"
270080,Al-Belem,202503,2151,719,865,3735,4.820,"77,49%","44,63%"
270090,Al-Belo Monte,202503,4490,739,599,5828,5.898,"98,81%","76,13%"
270100,Al-Boca da Mata,202503,11058,1951,2287,15296,21.517,"71,09%","51,39%"
270110,Al-Branquinha,202503,4908,1657,1381,7946,9.786,"81,20%","50,15%"
270120,Al-Cacimbinhas,202503,4364,1735,1003,7102,10.701,"66,37%","40,78%"
270130,Al-Cajueiro,202503,9461,2047,2100,13608,16.605,"81,95%","56,98%"
270135,Al-Campestre,202503,3589,785,664,5038,6.807,"74,01%","52,73%"
270140,Al-Campo Alegre,202503,12370,4381,4594,21345,32.714,"65,25%","37,81%"
270150,Al-Campo Grande,202503,6772,832,608,8212,8.293,"99,02%","81,66%"
270160,Al-Canapi,202503,9569,2516,1314,13399,15.743,"85,11%","60,78%"
270170,Al-Capela,202503,5129,2619,1749,9497,15.068,"63,03%","34,04%"
270180,Al-Carneiros,202503,5307,1424,914,7645,9.200,"83,10%","57,68%"
270190,Al-Cha Preta,202503,4369,745,630,5744,6.010,"95,57%","72,70%"
270200,Al-Coite do Noia,202503,5275,1790,1544,8609,11.036,"78,01%","47,80%"
270210,Al-Colonia Leopoldina,202503,10454,1598,1508,13560,15.949,"85,02%","65,55%"
270220,Al-Coqueiro Seco,202503,2436,803,846,4085,5.700,"71,67%","42,74%"
270230,Al-Coruripe,202503,19671,5759,5461,30891,51.788,"59,65%","37,98%"
270235,Al-Craibas,202503,14324,3655,2944,20923,26.115,"80,12%","54,85%"
270240,Al-Delmiro Gouveia,202503,19630,8148,6710,34488,52.809,"65,31%","37,17%"
270250,Al-Dois Riachos,202503,6189,1195,1318,8702,9.906,"87,85%","62,48%"
270255,Al-Estrela de Alagoas,202503,7700,2745,3117,13562,15.701,"86,38%","49,04%"
270260,Al-Feira Grande,202503,12418,3233,2012,17663,23.191,"76,16%","53,55%"
270270,Al-Feliz Deserto,202503,1797,612,462,2871,4.038,"71,10%","44,50%"
270280,Al-Flexeiras,202503,5883,1683,1729,9295,9.767,"95,17%","60,23%"
270290,Al-Girau do Ponciano,202503,20384,3780,2880,27044,37.335,"72,44%","54,60%"
270300,Al-Ibateguara,202503,6403,2171,1832,10406,13.992,"74,37%","45,76%"
270310,Al-Igaci,202503,11856,4280,3010,19146,24.452,"78,30%","48,49%"
270320,Al-Igreja Nova,202503,9079,4469,3681,17229,22.125,"77,87%","41,04%"
270330,Al-Inhapi,202503,10746,2227,1653,14626,15.417,"94,87%","69,70%"
270340,Al-Jacare dos Homens,202503,3361,558,760,4679,5.182,"90,29%","64,86%"
270350,Al-Jacuipe,202503,2600,892,884,4376,5.432,"80,56%","47,86%"
270360,Al-Japaratinga,202503,6388,907,685,7980,9.443,"84,51%","67,65%"
270370,Al-Jaramataia,202503,2891,854,676,4421,5.075,"87,11%","56,97%"
270375,Al-Jequia da Praia,202503,6024,1024,1016,8064,9.625,"83,78%","62,59%"
270380,Al-Joaquim Gomes,202503,10780,2154,2247,15181,17.386,"87,32%","62,00%"
270390,Al-Jundia,202503,2236,595,580,3411,4.176,"81,68%","53,54%"
270400,Al-Junqueiro,202503,9752,4399,3306,17457,24.381,"71,60%","40,00%"
270410,Al-Lagoa da Canoa,202503,10744,2587,2044,15375,18.831,"81,65%","57,05%"
270420,Al-Limoeiro de Anadia,202503,14126,3248,1902,19276,25.197,"76,50%","56,06%"
270430,Al-Maceio,202503,243329,108786,99063,451178,994.464,"45,37%","24,47%"
270440,Al-Major Isidoro,202503,8147,2873,1883,12903,17.834,"72,35%","45,68%"
270450,Al-Maragogi,202503,16426,3602,2793,22821,33.232,"68,67%","49,43%"
270460,Al-Maravilha,202503,5616,1637,1717,8970,9.715,"92,33%","57,81%"
270470,Al-Marechal Deodoro,202503,22531,7699,5736,35966,62.341,"57,69%","36,14%"
270480,Al-Maribondo,202503,5317,1452,1413,8182,13.968,"58,58%","38,07%"
270490,Al-Mar Vermelho,202503,1473,708,397,2578,3.212,"80,26%","45,86%"
270500,Al-Mata Grande,202503,10935,2446,1534,14915,22.147,"67,35%","49,37%"
270510,Al-Matriz de Camaragibe,202503,10709,3072,2540,16321,24.330,"67,08%","44,02%"
270520,Al-Messias,202503,5937,3012,2492,11441,15.707,"72,84%","37,80%"
270530,Al-Minador do Negrao,202503,2552,819,817,4188,4.938,"84,81%","51,68%"
270540,Al-Monteiropolis,202503,4193,1156,917,6266,7.341,"85,36%","57,12%"
270550,Al-Murici,202503,10628,4003,3141,17772,25.933,"68,53%","40,98%"
270560,Al-Novo Lino,202503,5391,1329,1340,8060,10.298,"78,27%","52,35%"
270570,Al-Olho D Agua das Flores,202503,9142,2708,2309,14159,21.132,"67,00%","43,26%"
270580,Al-Olho D Agua do Casado,202503,5220,1095,945,7260,8.522,"85,19%","61,25%"
270590,Al-Olho D Agua Grande,202503,3236,647,338,4221,4.384,"96,28%","73,81%"
270600,Al-Olivenca,202503,6456,1438,1003,8897,11.048,"80,53%","58,44%"
270610,Al-Ouro Branco,202503,6935,1799,1183,9917,11.699,"84,77%","59,28%"
270620,Al-Palestina,202503,2673,716,706,4095,4.410,"92,86%","60,61%"
270630,Al-Palmeira dos Indios,202503,32053,7201,6444,45698,73.596,"62,09%","43,55%"
270640,Al-Pao de Acucar,202503,10478,3517,3133,17128,24.291,"70,51%","43,14%"
270642,Al-Pariconha,202503,5617,1970,1536,9123,10.803,"84,45%","51,99%"
270644,Al-Paripueira,202503,6509,2313,1475,10297,14.176,"72,64%","45,92%"
270650,Al-Passo de Camaragibe,202503,5741,2574,1780,10095,14.076,"71,72%","40,79%"
270660,Al-Paulo Jacinto,202503,3349,880,715,4944,6.697,"73,82%","50,01%"
270670,Al-Penedo,202503,28129,7986,8557,44672,60.189,"74,22%","46,73%"
270680,Al-Piacabucu,202503,10821,1364,1296,13481,16.201,"83,21%","66,79%"
270690,Al-Pilar,202503,16273,5433,5058,26764,36.499,"73,33%","44,58%"
270700,Al-Pindoba,202503,987,506,294,1787,2.786,"64,14%","35,43%"
270710,Al-Piranhas,202503,12138,3933,2738,18809,23.053,"81,59%","52,65%"
270720,Al-Poco das Trincheiras,202503,7392,1751,1499,10642,12.974,"82,03%","56,98%"
270730,Al-Porto Calvo,202503,11585,2896,2540,17021,24.520,"69,42%","47,25%"
270740,Al-Porto de Pedras,202503,4440,1324,864,6628,9.508,"69,71%","46,70%"
270750,Al-Porto Real do Colegio,202503,11963,1869,1477,15309,20.262,"75,56%","59,04%"
270760,Al-Quebrangulo,202503,6084,1634,1587,9305,11.305,"82,31%","53,82%"
270770,Al-Rio Largo,202503,33103,15450,14061,62614,97.435,"64,26%","33,97%"
270780,Al-Roteiro,202503,4075,581,477,5133,6.607,"77,69%","61,68%"
270790,Al-Santa Luzia do Norte,202503,3136,873,836,4845,7.065,"68,58%","44,39%"
270800,Al-Santana do Ipanema,202503,19781,6749,4849,31379,47.397,"66,20%","41,73%"
270810,Al-Santana do Mundau,202503,5682,1901,2059,9642,11.568,"83,35%","49,12%"
270820,Al-Sao Bras,202503,3447,1034,793,5274,6.557,"80,43%","52,57%"
270830,Al-Sao Jose da Laje,202503,8049,2485,2243,12777,21.193,"60,29%","37,98%"
270840,Al-Sao Jose da Tapera,202503,16333,6099,4166,26598,31.557,"84,29%","51,76%"
270850,Al-Sao Luis do Quitunde,202503,14306,3044,2447,19797,31.792,"62,27%","45,00%"
270860,Al-Sao Miguel dos Campos,202503,20594,6404,6941,33939,53.391,"63,57%","38,57%"
270870,Al-Sao Miguel dos Milagres,202503,4114,1745,1636,7495,8.687,"86,28%","47,36%"
270880,Al-Sao Sebastiao,202503,16772,5153,3653,25578,32.701,"78,22%","51,29%"
270890,Al-Satuba,202503,5532,2973,2308,10813,25.000,"43,25%","22,13%"
270895,Al-Senador Rui Palmeira,202503,7530,1941,1511,10982,12.549,"87,51%","60,00%"
270900,Al-Tanque D Arca,202503,2514,962,838,4314,5.909,"73,01%","42,55%"
270910,Al-Taquarana,202503,9222,2621,2273,14116,19.422,"72,68%","47,48%"
270915,Al-Teotonio Vilela,202503,14891,6793,6434,28118,39.161,"71,80%","38,03%"
270920,Al-Traipu,202503,12009,3727,2879,18615,24.124,"77,16%","49,78%"
270930,Al-Uniao dos Palmares,202503,25161,9123,8186,42470,60.874,"69,77%","41,33%"
270940,Al-Vicosa,202503,10607,3706,2404,16717,24.423,"68,45%","43,43%"
280010,Se-Amparo de Sao Francisco,202503,878,460,456,1794,2.206,"81,32%","39,80%"
280020,Se-Aquidaba,202503,8075,2657,2411,13143,20.542,"63,98%","39,31%"
280030,Se-Aracaju,202503,127413,62855,51690,241958,628.849,"38,48%","20,26%"
280040,Se-Araua,202503,5208,1805,1534,8547,10.483,"81,53%","49,68%"
280050,Se-Areia Branca,202503,6487,3516,2922,12925,18.560,"69,64%","34,95%"
280060,Se-Barra dos Coqueiros,202503,11047,5353,4910,21310,44.384,"48,01%","24,89%"
280067,Se-Boquim,202503,11104,3384,3257,17745,25.038,"70,87%","44,35%"
280070,Se-Brejo Grande,202503,3864,1432,720,6016,8.016,"75,05%","48,20%"
280100,Se-Campo do Brito,202503,7005,2675,2176,11856,18.646,"63,58%","37,57%"
280110,Se-Canhoba,202503,2746,709,651,4106,3.855,"106,51%","71,23%"
280120,Se-Caninde de Sao Francisco,202503,15387,4321,3395,23103,33.491,"68,98%","45,94%"
280130,Se-Capela,202503,12834,4340,3162,20336,32.716,"62,16%","39,23%"
280140,Se-Carira,202503,9855,2264,2065,14184,20.315,"69,82%","48,51%"
280150,Se-Carmopolis,202503,5352,2110,2418,9880,14.179,"69,68%","37,75%"
280160,Se-Cedro de Sao Joao,202503,2163,952,702,3817,5.482,"69,63%","39,46%"
280170,Se-Cristinapolis,202503,8863,2868,2055,13786,17.539,"78,60%","50,53%"
280190,Se-Cumbe,202503,1972,525,466,2963,3.906,"75,86%","50,49%"
280200,Se-Divina Pastora,202503,1950,743,609,3302,4.433,"74,49%","43,99%"
280210,Se-Estancia,202503,25756,10219,9350,45325,66.978,"67,67%","38,45%"
280220,Se-Feira Nova,202503,3066,770,656,4492,6.207,"72,37%","49,40%"
280230,Se-Frei Paulo,202503,6660,2570,2210,11440,14.884,"76,86%","44,75%"
280240,Se-Gararu,202503,6338,1512,1134,8984,11.301,"79,50%","56,08%"
280250,Se-General Maynard,202503,1511,354,670,2535,3.111,"81,49%","48,57%"
280260,Se-Gracho Cardoso,202503,4248,686,808,5742,5.979,"96,04%","71,05%"
280270,Se-Ilha das Flores,202503,5154,1006,899,7059,8.495,"83,10%","60,67%"
280280,Se-Indiaroba,202503,7937,2276,1614,11827,16.949,"69,78%","46,83%"
280290,Se-Itabaiana,202503,29603,15734,12169,57506,108.408,"53,05%","27,31%"
280300,Se-Itabaianinha,202503,23577,4238,3474,31289,42.114,"74,30%","55,98%"
280310,Se-Itabi,202503,2239,702,663,3604,4.823,"74,73%","46,42%"
280320,Se-Itaporanga D Ajuda,202503,14892,5735,4251,24878,35.863,"69,37%","41,52%"
280330,Se-Japaratuba,202503,6411,2434,2740,11585,16.472,"70,33%","38,92%"
280340,Se-Japoata,202503,7308,1736,1774,10818,13.707,"78,92%","53,32%"
280350,Se-Lagarto,202503,43464,14424,12923,70811,105.558,"67,08%","41,18%"
280360,Se-Laranjeiras,202503,9033,4226,3809,17068,24.170,"70,62%","37,37%"
280370,Se-Macambira,202503,3540,1122,1204,5866,7.024,"83,51%","50,40%"
280380,Se-Malhada dos Bois,202503,1621,680,589,2890,3.666,"78,83%","44,22%"
280390,Se-Malhador,202503,5976,1689,1776,9441,11.728,"80,50%","50,95%"
280400,Se-Maruim,202503,6494,1801,1629,9924,15.975,"62,12%","40,65%"
280410,Se-Moita Bonita,202503,4458,2069,1838,8365,11.288,"74,11%","39,49%"
280420,Se-Monte Alegre de Sergipe,202503,9414,1577,1591,12582,14.732,"85,41%","63,90%"
280430,Se-Muribeca,202503,3802,957,791,5550,8.033,"69,09%","47,33%"
280440,Se-Neopolis,202503,7466,2118,2213,11797,16.558,"71,25%","45,09%"
280445,Se-Nossa Senhora Aparecida,202503,4217,1347,811,6375,9.496,"67,13%","44,41%"
280450,Se-Nossa Senhora da Gloria,202503,17060,5418,4009,26487,43.255,"61,23%","39,44%"
280460,Se-Nossa Senhora das Dores,202503,11970,2987,2044,17001,25.537,"66,57%","46,87%"
280470,Se-Nossa Senhora de Lourdes,202503,2957,1080,1094,5131,6.404,"80,12%","46,17%"
280480,Se-Nossa Senhora do Socorro,202503,71459,30358,23491,125308,202.450,"61,90%","35,30%"
280490,Se-Pacatuba,202503,5969,2538,1940,10447,12.709,"82,20%","46,97%"
280500,Se-Pedra Mole,202503,1759,318,355,2432,2.818,"86,30%","62,42%"
280510,Se-Pedrinhas,202503,5909,584,1060,7553,7.416,"101,85%","79,68%"
280520,Se-Pinhao,202503,2921,939,688,4548,5.769,"78,84%","50,63%"
280530,Se-Pirambu,202503,3781,1294,1122,6197,8.037,"77,11%","47,04%"
280540,Se-Poco Redondo,202503,18387,3195,2988,24570,29.117,"84,38%","63,15%"
280550,Se-Poco Verde,202503,10902,2748,2691,16341,22.214,"73,56%","49,08%"
280560,Se-Porto da Folha,202503,17042,2694,2198,21934,27.350,"80,20%","62,31%"
280570,Se-Propria,202503,10415,3465,3064,16944,27.273,"62,13%","38,19%"
280580,Se-Riachao do Dantas,202503,10712,2311,2065,15088,18.579,"81,21%","57,66%"
280590,Se-Riachuelo,202503,3720,1411,1342,6473,8.875,"72,94%","41,92%"
280600,Se-Ribeiropolis,202503,6822,2331,1746,10899,17.362,"62,78%","39,29%"
280610,Se-Rosario do Catete,202503,4446,1175,1195,6816,9.499,"71,75%","46,80%"
280620,Se-Salgado,202503,9926,2752,2988,15666,20.772,"75,42%","47,79%"
280630,Se-Santa Luzia do Itanhy,202503,6894,2396,1743,11033,13.965,"79,00%","49,37%"
280640,Se-Santana do Sao Francisco,202503,4668,768,910,6346,7.530,"84,28%","61,99%"
280650,Se-Santa Rosa de Lima,202503,1519,831,688,3038,4.038,"75,24%","37,62%"
280660,Se-Santo Amaro das Brotas,202503,5450,1203,1190,7843,11.297,"69,43%","48,24%"
280670,Se-Sao Cristovao,202503,27358,13671,10577,51606,100.360,"51,42%","27,26%"
280680,Se-Sao Domingos,202503,4654,1347,1397,7398,10.550,"70,12%","44,11%"
280690,Se-Sao Francisco,202503,1601,438,467,2506,3.323,"75,41%","48,18%"
280700,Se-Sao Miguel do Aleixo,202503,2008,401,530,2939,3.481,"84,43%","57,68%"
280710,Se-Simao Dias,202503,21767,5656,5150,32573,44.285,"73,55%","49,15%"
280720,Se-Siriri,202503,3719,938,1062,5719,7.984,"71,63%","46,58%"
280730,Se-Telha,202503,1756,635,455,2846,3.373,"84,38%","52,06%"
280740,Se-Tobias Barreto,202503,24599,7035,6691,38325,52.613,"72,84%","46,75%"
280750,Se-Tomar do Geru,202503,6420,2080,1609,10109,12.145,"83,24%","52,86%"
280760,Se-Umbauba,202503,12810,3236,3442,19488,24.538,"79,42%","52,20%"
290010,Ba-Abaira,202503,3673,796,1568,6037,7.452,"81,01%","49,29%"
290020,Ba-Abare,202503,9950,2351,1304,13605,18.240,"74,59%","54,55%"
290030,Ba-Acajutiba,202503,7213,1898,1595,10706,14.215,"75,31%","50,74%"
290035,Ba-Adustina,202503,7855,1600,1632,11087,14.554,"76,18%","53,97%"
290040,Ba-Agua Fria,202503,9059,1081,1931,12071,14.871,"81,17%","60,92%"
290050,Ba-Erico Cardoso,202503,3627,1666,1361,6654,10.948,"60,78%","33,13%"
290060,Ba-Aiquara,202503,1901,662,900,3463,4.586,"75,51%","41,45%"
290070,Ba-Alagoinhas,202503,53423,18953,18200,90576,160.662,"56,38%","33,25%"
290080,Ba-Alcobaca,202503,11956,4338,3470,19764,25.494,"77,52%","46,90%"
290090,Ba-Almadina,202503,2722,346,956,4024,5.327,"75,54%","51,10%"
290100,Ba-Amargosa,202503,11996,7597,5897,25490,38.478,"66,25%","31,18%"
290110,Ba-Amelia Rodrigues,202503,6971,4045,3911,14927,24.848,"60,07%","28,05%"
290115,Ba-America Dourada,202503,8370,2398,1962,12730,15.583,"81,69%","53,71%"
290120,Ba-Anage,202503,11650,2397,3265,17312,26.715,"64,80%","43,61%"
290130,Ba-Andarai,202503,6157,1868,2233,10258,13.531,"75,81%","45,50%"
290135,Ba-Andorinha,202503,6579,1865,3006,11450,15.485,"73,94%","42,49%"
290140,Ba-Angical,202503,7327,1717,2114,11158,14.178,"78,70%","51,68%"
290150,Ba-Anguera,202503,4730,1125,1331,7186,11.456,"62,73%","41,29%"
290160,Ba-Antas,202503,5866,995,1050,7911,15.061,"52,53%","38,95%"
290170,Ba-Antonio Cardoso,202503,6276,1136,1135,8547,11.501,"74,32%","54,57%"
290180,Ba-Antonio Goncalves,202503,5253,1396,1487,8136,11.236,"72,41%","46,75%"
290190,Ba-Apora,202503,9152,1625,1171,11948,16.379,"72,95%","55,88%"
290195,Ba-Apuarema,202503,4215,970,1124,6309,7.114,"88,68%","59,25%"
290200,Ba-Aracatu,202503,6430,2619,3218,12267,14.422,"85,06%","44,58%"
290205,Ba-Aracas,202503,6553,1554,1625,9732,11.946,"81,47%","54,86%"
290210,Ba-Araci,202503,25969,6407,6047,38423,50.336,"76,33%","51,59%"
290220,Ba-Aramari,202503,4850,1298,1276,7424,10.122,"73,35%","47,92%"
290225,Ba-Arataca,202503,3819,909,1240,5968,10.463,"57,04%","36,50%"
290230,Ba-Aratuipe,202503,5609,975,664,7248,8.981,"80,70%","62,45%"
290240,Ba-Aurelino Leal,202503,6133,1645,1577,9355,11.409,"82,00%","53,76%"
290250,Ba-Baianopolis,202503,7392,1838,1900,11130,14.110,"78,88%","52,39%"
290260,Ba-Baixa Grande,202503,9058,1927,2032,13017,18.680,"69,68%","48,49%"
290265,Ba-Banzae,202503,5325,2643,2258,10226,12.309,"83,08%","43,26%"
290270,Ba-Barra,202503,25744,7863,4611,38218,53.528,"71,40%","48,09%"
290280,Ba-Barra da Estiva,202503,10662,4573,3712,18947,27.582,"68,69%","38,66%"
290290,Ba-Barra do Choca,202503,13423,9140,7554,30117,38.481,"78,26%","34,88%"
290300,Ba-Barra do Mendes,202503,6476,2150,2866,11492,14.345,"80,11%","45,14%"
290310,Ba-Barra do Rocha,202503,3751,385,1014,5150,5.920,"86,99%","63,36%"
290320,Ba-Barreiras,202503,43969,20730,18198,82897,170.667,"48,57%","25,76%"
290323,Ba-Barro Alto,202503,7155,2088,1971,11214,13.911,"80,61%","51,43%"
290327,Ba-Barrocas,202503,6908,2682,3046,12636,15.743,"80,26%","43,88%"
290330,Ba-Barro Preto,202503,3886,398,834,5118,5.966,"85,79%","65,14%"
290340,Ba-Belmonte,202503,9749,2401,2700,14850,20.567,"72,20%","47,40%"
290350,Ba-Belo Campo,202503,8750,2976,2973,14699,19.042,"77,19%","45,95%"
290360,Ba-Biritinga,202503,8481,2297,2476,13254,15.606,"84,93%","54,34%"
290370,Ba-Boa Nova,202503,6503,1974,2310,10787,14.052,"76,76%","46,28%"
290380,Ba-Boa Vista do Tupim,202503,9851,1791,2660,14302,17.307,"82,64%","56,92%"
290390,Ba-Bom Jesus da Lapa,202503,25696,10359,8617,44672,68.704,"65,02%","37,40%"
290395,Ba-Bom Jesus da Serra,202503,5246,1469,1982,8697,10.028,"86,73%","52,31%"
290400,Ba-Boninal,202503,6026,2241,2168,10435,14.104,"73,99%","42,73%"
290405,Ba-Bonito,202503,8224,3061,2237,13522,16.393,"82,49%","50,17%"
290410,Ba-Boquira,202503,9172,2841,3078,15091,19.829,"76,11%","46,26%"
290420,Ba-Botupora,202503,5174,1808,1725,8707,11.411,"76,30%","45,34%"
290430,Ba-Brejoes,202503,6218,1432,1508,9158,13.272,"69,00%","46,85%"
290440,Ba-Brejolandia,202503,3899,1304,1677,6880,9.377,"73,37%","41,58%"
290450,Ba-Brotas de Macaubas,202503,5718,1307,1816,8841,12.169,"72,65%","46,99%"
290460,Ba-Brumado,202503,14111,13307,11683,39101,74.095,"52,77%","19,04%"
290470,Ba-Buerarema,202503,6478,2218,2651,11347,15.056,"75,37%","43,03%"
290475,Ba-Buritirama,202503,12718,3016,3293,19027,20.212,"94,14%","62,92%"
290480,Ba-Caatiba,202503,2709,954,1335,4998,6.224,"80,30%","43,53%"
290485,Ba-Cabaceiras do Paraguacu,202503,9414,2549,1744,13707,17.039,"80,44%","55,25%"
290490,Ba-Cachoeira,202503,15148,3741,2857,21746,30.550,"71,18%","49,58%"
290500,Ba-Cacule,202503,5637,4032,3502,13171,23.246,"56,66%","24,25%"
290510,Ba-Caem,202503,6248,1069,1136,8453,10.729,"78,79%","58,23%"
290515,Ba-Caetanos,202503,6487,1861,1578,9926,11.500,"86,31%","56,41%"
290520,Ba-Caetite,202503,19069,8591,8031,35691,54.572,"65,40%","34,94%"
290530,Ba-Cafarnaum,202503,9889,2350,2253,14492,18.039,"80,34%","54,82%"
290540,Ba-Cairu,202503,8732,2117,1173,12022,18.486,"65,03%","47,24%"
290550,Ba-Caldeirao Grande,202503,8817,846,1220,10883,13.566,"80,22%","64,99%"
290560,Ba-Camacan,202503,7916,4578,4222,16716,22.756,"73,46%","34,79%"
290570,Ba-Camacari,202503,100822,33274,29926,164022,319.394,"51,35%","31,57%"
290580,Ba-Camamu,202503,16549,4296,3135,23980,31.775,"75,47%","52,08%"
290590,Ba-Campo Alegre de Lourdes,202503,15572,3807,2991,22370,32.377,"69,09%","48,10%"
290600,Ba-Campo Formoso,202503,36962,9483,10196,56641,74.894,"75,63%","49,35%"
290610,Ba-Canapolis,202503,4595,1706,1421,7722,10.612,"72,77%","43,30%"
290620,Ba-Canarana,202503,12567,3111,2554,18232,24.989,"72,96%","50,29%"
290630,Ba-Canavieiras,202503,15371,4087,4223,23681,34.343,"68,95%","44,76%"
290640,Ba-Candeal,202503,4049,921,1539,6509,7.969,"81,68%","50,81%"
290650,Ba-Candeias,202503,30333,6617,5967,42917,75.083,"57,16%","40,40%"
290660,Ba-Candiba,202503,5535,2182,2654,10371,13.425,"77,25%","41,23%"
290670,Ba-Candido Sales,202503,14074,2639,3891,20604,26.465,"77,85%","53,18%"
290680,Ba-Cansancao,202503,20552,5640,5555,31747,39.556,"80,26%","51,96%"
290682,Ba-Canudos,202503,9023,1768,1571,12362,16.662,"74,19%","54,15%"
290685,Ba-Capela do Alto Alegre,202503,4644,1553,2259,8456,11.055,"76,49%","42,01%"
290687,Ba-Capim Grosso,202503,12632,4620,3594,20846,35.228,"59,17%","35,86%"
290689,Ba-Caraibas,202503,4210,1689,2155,8054,10.260,"78,50%","41,03%"
290690,Ba-Caravelas,202503,8573,3242,3192,15007,21.229,"70,69%","40,38%"
290700,Ba-Cardeal da Silva,202503,5504,856,991,7351,8.634,"85,14%","63,75%"
290710,Ba-Carinhanha,202503,17889,3198,3451,24538,30.375,"80,78%","58,89%"
290720,Ba-Casa Nova,202503,36326,11438,7694,55458,75.815,"73,15%","47,91%"
290730,Ba-Castro Alves,202503,10519,4174,2953,17646,25.471,"69,28%","41,30%"
290740,Ba-Catolandia,202503,1891,393,592,2876,3.560,"80,79%","53,12%"
290750,Ba-Catu,202503,19609,5618,8192,33419,50.153,"66,63%","39,10%"
290755,Ba-Caturama,202503,3360,1201,1156,5717,9.115,"62,72%","36,86%"
290760,Ba-Central,202503,7323,2484,2645,12452,16.849,"73,90%","43,46%"
290770,Ba-Chorrocho,202503,6579,1038,904,8521,10.929,"77,97%","60,20%"
290780,Ba-Cicero Dantas,202503,11708,4096,4185,19989,32.268,"61,95%","36,28%"
290790,Ba-Cipo,202503,9156,2631,2495,14282,17.836,"80,07%","51,33%"
290800,Ba-Coaraci,202503,7987,2265,3135,13387,17.663,"75,79%","45,22%"
290810,Ba-Cocos,202503,8578,2461,2751,13790,19.817,"69,59%","43,29%"
290820,Ba-Conceicao da Feira,202503,8164,3168,2984,14316,21.499,"66,59%","37,97%"
290830,Ba-Conceicao do Almeida,202503,5898,2775,2194,10867,16.184,"67,15%","36,44%"
290840,Ba-Conceicao do Coite,202503,28940,12593,9740,51273,71.316,"71,90%","40,58%"
290850,Ba-Conceicao do Jacuipe,202503,12532,4340,3806,20678,37.409,"55,28%","33,50%"
290860,Ba-Conde,202503,13838,2474,2175,18487,24.434,"75,66%","56,63%"
290870,Ba-Condeuba,202503,7287,2761,3747,13795,17.571,"78,51%","41,47%"
290880,Ba-Contendas do Sincora,202503,2045,794,696,3535,4.490,"78,73%","45,55%"
290890,Ba-Coracao de Maria,202503,13526,3011,2813,19350,28.258,"68,48%","47,87%"
290900,Ba-Cordeiros,202503,3213,1457,1839,6509,7.763,"83,85%","41,39%"
290910,Ba-Coribe,202503,8137,1496,2589,12222,14.464,"84,50%","56,26%"
290920,Ba-Coronel Joao Sa,202503,9640,1705,1327,12672,17.593,"72,03%","54,79%"
290930,Ba-Correntina,202503,11602,5188,4190,20980,34.179,"61,38%","33,94%"
290940,Ba-Cotegipe,202503,6365,1831,1711,9907,13.472,"73,54%","47,25%"
290950,Ba-Cravolandia,202503,2055,798,788,3641,4.514,"80,66%","45,53%"
290960,Ba-Crisopolis,202503,11377,2098,1789,15264,20.343,"75,03%","55,93%"
290970,Ba-Cristopolis,202503,5930,2059,1668,9657,14.514,"66,54%","40,86%"
290980,Ba-Cruz das Almas,202503,22233,7682,6933,36848,63.203,"58,30%","35,18%"
290990,Ba-Curaca,202503,17948,5371,3858,27177,36.021,"75,45%","49,83%"
291000,Ba-Dario Meira,202503,5227,1636,1418,8281,11.094,"74,64%","47,12%"
291005,Ba-Dias D Avila,202503,27676,8508,7903,44087,75.053,"58,74%","36,88%"
291010,Ba-Dom Basilio,202503,5000,2390,2520,9910,12.309,"80,51%","40,62%"
291020,Ba-Dom Macedo Costa,202503,1867,753,707,3327,4.588,"72,52%","40,69%"
291030,Ba-Elisio Medrado,202503,2913,1288,1118,5319,8.066,"65,94%","36,11%"
291040,Ba-Encruzilhada,202503,9544,2962,2874,15380,19.535,"78,73%","48,86%"
291050,Ba-Entre Rios,202503,17560,4927,4854,27341,39.902,"68,52%","44,01%"
291060,Ba-Esplanada,202503,14822,4695,3627,23144,34.146,"67,78%","43,41%"
291070,Ba-Euclides da Cunha,202503,31470,7064,8037,46571,64.547,"72,15%","48,76%"
291072,Ba-Eunapolis,202503,32306,18326,20806,71438,120.515,"59,28%","26,81%"
291075,Ba-Fatima,202503,9180,2801,2090,14071,18.469,"76,19%","49,70%"
291077,Ba-Feira da Mata,202503,2384,1154,1124,4662,5.825,"80,03%","40,93%"
291080,Ba-Feira de Santana,202503,171111,91584,83683,346378,657.948,"52,65%","26,01%"
291085,Ba-Filadelfia,202503,9885,2407,3003,15295,18.573,"82,35%","53,22%"
291090,Ba-Firmino Alves,202503,2624,556,873,4053,5.006,"80,96%","52,42%"
291100,Ba-Floresta Azul,202503,4039,1126,1760,6925,11.442,"60,52%","35,30%"
291110,Ba-Formosa do Rio Preto,202503,11053,4361,3556,18970,27.421,"69,18%","40,31%"
291120,Ba-Gandu,202503,12134,3594,2934,18662,33.938,"54,99%","35,75%"
291125,Ba-Gaviao,202503,2701,434,816,3951,4.493,"87,94%","60,12%"
291130,Ba-Gentio do Ouro,202503,4528,1987,2401,8916,11.263,"79,16%","40,20%"
291140,Ba-Gloria,202503,6198,3153,4629,13980,16.072,"86,98%","38,56%"
291150,Ba-Gongogi,202503,3760,494,1182,5436,5.567,"97,65%","67,54%"
291160,Ba-Governador Mangabeira,202503,7197,4191,3142,14530,21.314,"68,17%","33,77%"
291165,Ba-Guajeru,202503,2675,1302,1992,5969,8.225,"72,57%","32,52%"
291170,Ba-Guanambi,202503,29816,16415,15612,61843,93.065,"66,45%","32,04%"
291180,Ba-Guaratinga,202503,10646,1421,3094,15161,19.490,"77,79%","54,62%"
291185,Ba-Heliopolis,202503,6353,1387,1302,9042,13.074,"69,16%","48,59%"
291190,Ba-Iacu,202503,11114,4019,3052,18185,25.333,"71,78%","43,87%"
291200,Ba-Ibiassuce,202503,3500,2038,2213,7751,10.754,"72,08%","32,55%"
291210,Ba-Ibicarai,202503,10385,2319,3913,16617,22.200,"74,85%","46,78%"
291220,Ba-Ibicoara,202503,7984,3420,2671,14075,21.690,"64,89%","36,81%"
291230,Ba-Ibicui,202503,6723,945,1667,9335,14.306,"65,25%","46,99%"
291240,Ba-Ibipeba,202503,7494,1874,2054,11422,17.128,"66,69%","43,75%"
291250,Ba-Ibipitanga,202503,4940,2798,2479,10217,14.316,"71,37%","34,51%"
291260,Ba-Ibiquera,202503,2475,516,651,3642,3.837,"94,92%","64,50%"
291270,Ba-Ibirapitanga,202503,8935,2415,2705,14055,26.794,"52,46%","33,35%"
291280,Ba-Ibirapua,202503,3286,1632,1847,6765,9.259,"73,06%","35,49%"
291290,Ba-Ibirataia,202503,7601,3481,3415,14497,19.375,"74,82%","39,23%"
291300,Ba-Ibitiara,202503,6291,2031,1885,10207,15.062,"67,77%","41,77%"
291310,Ba-Ibitita,202503,9966,1744,2066,13776,17.509,"78,68%","56,92%"
291320,Ba-Ibotirama,202503,10756,3634,3768,18158,27.670,"65,62%","38,87%"
291330,Ba-Ichu,202503,3081,1006,1044,5131,6.415,"79,98%","48,03%"
291340,Ba-Igapora,202503,6216,2638,2392,11246,16.047,"70,08%","38,74%"
291345,Ba-Igrapiuna,202503,5704,1462,1043,8209,13.528,"60,68%","42,16%"
291350,Ba-Iguai,202503,10219,2849,2914,15982,21.897,"72,99%","46,67%"
291360,Ba-Ilheus,202503,53223,23638,21917,98778,189.028,"52,26%","28,16%"
291370,Ba-Inhambupe,202503,14539,5046,3269,22854,35.397,"64,56%","41,07%"
291380,Ba-Ipecaeta,202503,7871,1903,1816,11590,14.064,"82,41%","55,97%"
291390,Ba-Ipiau,202503,17358,4301,5773,27432,42.507,"64,54%","40,84%"
291400,Ba-Ipira,202503,24265,7390,8110,39765,59.264,"67,10%","40,94%"
291410,Ba-Ipupiara,202503,4694,1296,1633,7623,10.318,"73,88%","45,49%"
291420,Ba-Irajuba,202503,3229,672,929,4830,6.255,"77,22%","51,62%"
291430,Ba-Iramaia,202503,4501,1474,1249,7224,11.060,"65,32%","40,70%"
291440,Ba-Iraquara,202503,12708,3778,3288,19774,24.759,"79,87%","51,33%"
291450,Ba-Irara,202503,17675,2391,3653,23719,29.509,"80,38%","59,90%"
291460,Ba-Irece,202503,29154,10218,8736,48108,78.425,"61,34%","37,17%"
291465,Ba-Itabela,202503,13300,4185,3258,20743,29.563,"70,17%","44,99%"
291470,Ba-Itaberaba,202503,26814,8562,8040,43416,68.244,"63,62%","39,29%"
291480,Ba-Itabuna,202503,48145,27405,28681,104231,196.676,"53,00%","24,48%"
291490,Ba-Itacare,202503,13112,2751,2151,18014,29.337,"61,40%","44,69%"
291500,Ba-Itaete,202503,8852,1328,1807,11987,13.822,"86,72%","64,04%"
291510,Ba-Itagi,202503,7259,1351,2204,10814,14.314,"75,55%","50,71%"
291520,Ba-Itagiba,202503,6358,2123,2486,10967,15.792,"69,45%","40,26%"
291530,Ba-Itagimirim,202503,2751,1063,1280,5094,6.512,"78,22%","42,25%"
291535,Ba-Itaguacu da Bahia,202503,7541,1920,2080,11541,12.683,"91,00%","59,46%"
291540,Ba-Itaju do Colonia,202503,3192,577,1257,5026,6.157,"81,63%","51,84%"
291550,Ba-Itajuipe,202503,8436,2351,3365,14152,19.249,"73,52%","43,83%"
291560,Ba-Itamaraju,202503,18684,13143,12139,43966,62.065,"70,84%","30,10%"
291570,Ba-Itamari,202503,3541,793,901,5235,7.219,"72,52%","49,05%"
291580,Ba-Itambe,202503,8071,4125,3984,16180,25.108,"64,44%","32,15%"
291590,Ba-Itanagra,202503,4281,852,865,5998,6.087,"98,54%","70,33%"
291600,Ba-Itanhem,202503,6849,2391,2820,12060,18.258,"66,05%","37,51%"
291610,Ba-Itaparica,202503,10390,2649,2196,15235,20.369,"74,80%","51,01%"
291620,Ba-Itape,202503,3858,1189,1210,6257,10.658,"58,71%","36,20%"
291630,Ba-Itapebi,202503,4416,890,1643,6949,9.501,"73,14%","46,48%"
291640,Ba-Itapetinga,202503,22883,9942,11381,44206,68.735,"64,31%","33,29%"
291650,Ba-Itapicuru,202503,16890,3831,2982,23703,33.254,"71,28%","50,79%"
291660,Ba-Itapitanga,202503,2548,1035,1224,4807,10.630,"45,22%","23,97%"
291670,Ba-Itaquara,202503,3219,1219,1005,5443,8.448,"64,43%","38,10%"
291680,Ba-Itarantim,202503,6091,2435,2067,10593,17.517,"60,47%","34,77%"
291685,Ba-Itatim,202503,7686,2535,2452,12673,16.375,"77,39%","46,94%"
291690,Ba-Itirucu,202503,5701,997,2049,8747,11.261,"77,68%","50,63%"
291700,Ba-Itiuba,202503,19336,3904,3508,26748,35.491,"75,37%","54,48%"
291710,Ba-Itororo,202503,7644,2084,2827,12555,16.945,"74,09%","45,11%"
291720,Ba-Ituacu,202503,8045,3225,2608,13878,18.493,"75,04%","43,50%"
291730,Ba-Itubera,202503,12232,2266,2327,16825,22.299,"75,45%","54,85%"
291733,Ba-Iuiu,202503,4862,1463,1386,7711,11.532,"66,87%","42,16%"
291735,Ba-Jaborandi,202503,4185,1609,1908,7702,9.592,"80,30%","43,63%"
291740,Ba-Jacaraci,202503,5417,2175,3951,11543,14.901,"77,46%","36,35%"
291750,Ba-Jacobina,202503,31302,10007,10146,51455,86.649,"59,38%","36,13%"
291760,Ba-Jaguaquara,202503,12647,12240,8339,33226,47.738,"69,60%","26,49%"
291770,Ba-Jaguarari,202503,12276,4443,5442,22161,34.440,"64,35%","35,64%"
291780,Ba-Jaguaripe,202503,10405,2158,1262,13825,18.300,"75,55%","56,86%"
291790,Ba-Jandaira,202503,5378,1339,801,7518,9.535,"78,85%","56,40%"
291800,Ba-Jequie,202503,45918,25030,22525,93473,168.733,"55,40%","27,21%"
291810,Ba-Jeremoabo,202503,19100,3915,3861,26876,39.501,"68,04%","48,35%"
291820,Ba-Jiquirica,202503,7001,2053,1498,10552,14.066,"75,02%","49,77%"
291830,Ba-Jitauna,202503,7175,1520,2099,10794,14.815,"72,86%","48,43%"
291835,Ba-Joao Dourado,202503,11677,4812,3665,20154,25.799,"78,12%","45,26%"
291840,Ba-Juazeiro,202503,94575,31740,21134,147449,254.481,"57,94%","37,16%"
291845,Ba-Jucurucu,202503,4820,1295,1283,7398,9.944,"74,40%","48,47%"
291850,Ba-Jussara,202503,9555,1569,2011,13135,16.956,"77,47%","56,35%"
291855,Ba-Jussari,202503,3174,364,750,4288,6.059,"70,77%","52,38%"
291860,Ba-Jussiape,202503,2868,1154,1925,5947,7.585,"78,40%","37,81%"
291870,Ba-Lafaiete Coutinho,202503,1470,826,1180,3476,4.221,"82,35%","34,83%"
291875,Ba-Lagoa Real,202503,6007,1950,1688,9645,14.546,"66,31%","41,30%"
291880,Ba-Laje,202503,11013,2547,2320,15880,21.704,"73,17%","50,74%"
291890,Ba-Lajedao,202503,1870,700,1154,3724,3.986,"93,43%","46,91%"
291900,Ba-Lajedinho,202503,1860,582,615,3057,3.621,"84,42%","51,37%"
291905,Ba-Lajedo do Tabocal,202503,3456,1276,1026,5758,7.702,"74,76%","44,87%"
291910,Ba-Lamarao,202503,5622,996,1421,8039,9.305,"86,39%","60,42%"
291915,Ba-Lapao,202503,13377,4202,3936,21515,26.998,"79,69%","49,55%"
291920,Ba-Lauro de Freitas,202503,57336,23111,17373,97820,217.960,"44,88%","26,31%"
291930,Ba-Lencois,202503,4582,1271,1126,6979,11.170,"62,48%","41,02%"
291940,Ba-Licinio de Almeida,202503,4683,2040,2792,9515,12.208,"77,94%","38,36%"
291950,Ba-Livramento de Nossa Senhora,202503,16065,7911,5571,29547,46.249,"63,89%","34,74%"
291955,Ba-Luis Eduardo Magalhaes,202503,35804,12581,9005,57390,116.662,"49,19%","30,69%"
291960,Ba-Macajuba,202503,6284,1285,1615,9184,10.758,"85,37%","58,41%"
291970,Ba-Macarani,202503,7488,2130,1916,11534,22.596,"51,04%","33,14%"
291980,Ba-Macaubas,202503,17099,6296,6178,29573,43.725,"67,63%","39,11%"
291990,Ba-Macurure,202503,4115,1010,648,5773,7.455,"77,44%","55,20%"
291992,Ba-Madre de Deus,202503,6315,2135,2244,10694,19.173,"55,78%","32,94%"
291995,Ba-Maetinga,202503,3742,988,1313,6043,7.212,"83,79%","51,89%"
292000,Ba-Maiquinique,202503,4056,968,1251,6275,9.011,"69,64%","45,01%"
292010,Ba-Mairi,202503,9417,1656,2228,13301,18.161,"73,24%","51,85%"
292020,Ba-Malhada,202503,8832,2138,2058,13028,15.834,"82,28%","55,78%"
292030,Ba-Malhada de Pedras,202503,3355,1843,1428,6626,8.972,"73,85%","37,39%"
292040,Ba-Manoel Vitorino,202503,7714,1599,2020,11333,14.295,"79,28%","53,96%"
292045,Ba-Mansidao,202503,7533,931,1201,9665,14.484,"66,73%","52,01%"
292050,Ba-Maracas,202503,9694,4489,3996,18179,29.197,"62,26%","33,20%"
292060,Ba-Maragogipe,202503,22127,4343,2771,29241,37.225,"78,55%","59,44%"
292070,Ba-Marau,202503,12885,2477,2047,17409,25.626,"67,93%","50,28%"
292080,Ba-Marcionilio Souza,202503,6192,1009,1306,8507,9.507,"89,48%","65,13%"
292090,Ba-Mascote,202503,5654,1459,2419,9532,13.941,"68,37%","40,56%"
292100,Ba-Mata de Sao Joao,202503,17338,8564,7819,33721,44.839,"75,20%","38,67%"
292105,Ba-Matina,202503,4929,2004,1509,8442,10.629,"79,42%","46,37%"
292110,Ba-Medeiros Neto,202503,8061,3348,3904,15313,22.925,"66,80%","35,16%"
292120,Ba-Miguel Calmon,202503,10274,3717,3798,17789,25.317,"70,27%","40,58%"
292130,Ba-Milagres,202503,4692,1848,1466,8006,11.434,"70,02%","41,04%"
292140,Ba-Mirangaba,202503,9390,1691,2294,13375,16.185,"82,64%","58,02%"
292145,Ba-Mirante,202503,4811,1422,1581,7814,10.523,"74,26%","45,72%"
292150,Ba-Monte Santo,202503,28480,6682,7143,42305,49.823,"84,91%","57,16%"
292160,Ba-Morpara,202503,4475,891,1196,6562,8.232,"79,71%","54,36%"
292170,Ba-Morro do Chapeu,202503,12990,5570,4528,23088,35.224,"65,55%","36,88%"
292180,Ba-Mortugaba,202503,3805,2209,2309,8323,11.487,"72,46%","33,12%"
292190,Ba-Mucuge,202503,4832,1773,1631,8236,12.650,"65,11%","38,20%"
292200,Ba-Mucuri,202503,8841,7536,7092,23469,40.005,"58,67%","22,10%"
292205,Ba-Mulungu do Morro,202503,8074,1429,1199,10702,13.625,"78,55%","59,26%"
292210,Ba-Mundo Novo,202503,11404,1294,2002,14700,17.417,"84,40%","65,48%"
292220,Ba-Muniz Ferreira,202503,3272,998,1055,5325,7.443,"71,54%","43,96%"
292225,Ba-Muquem de Sao Francisco,202503,6703,1649,1430,9782,10.796,"90,61%","62,09%"
292230,Ba-Muritiba,202503,13123,4257,3639,21019,30.146,"69,72%","43,53%"
292240,Ba-Mutuipe,202503,9437,3225,2685,15347,20.612,"74,46%","45,78%"
292250,Ba-Nazare,202503,11050,2631,2478,16159,28.403,"56,89%","38,90%"
292260,Ba-Nilo Pecanha,202503,6865,1394,1069,9328,12.418,"75,12%","55,28%"
292265,Ba-Nordestina,202503,7030,1607,1638,10275,19.500,"52,69%","36,05%"
292270,Ba-Nova Canaa,202503,6894,1586,1767,10247,14.035,"73,01%","49,12%"
292273,Ba-Nova Fatima,202503,4111,1041,1138,6290,8.264,"76,11%","49,75%"
292275,Ba-Nova Ibia,202503,2864,1122,724,4710,6.701,"70,29%","42,74%"
292280,Ba-Nova Itarana,202503,4902,747,955,6604,8.059,"81,95%","60,83%"
292285,Ba-Nova Redencao,202503,4100,742,1118,5960,7.708,"77,32%","53,19%"
292290,Ba-Nova Soure,202503,12451,3234,3174,18859,24.906,"75,72%","49,99%"
292300,Ba-Nova Vicosa,202503,14082,7004,6490,27576,41.551,"66,37%","33,89%"
292303,Ba-Novo Horizonte,202503,5768,1605,1533,8906,11.565,"77,01%","49,87%"
292305,Ba-Novo Triunfo,202503,4597,925,812,6334,11.197,"56,57%","41,06%"
292310,Ba-Olindina,202503,12071,2738,2441,17250,23.085,"74,72%","52,29%"
292320,Ba-Oliveira dos Brejinhos,202503,10056,2804,2919,15779,21.334,"73,96%","47,14%"
292330,Ba-Ouricangas,202503,4123,737,846,5706,7.939,"71,87%","51,93%"
292335,Ba-Ourolandia,202503,9787,2192,2087,14066,20.037,"70,20%","48,84%"
292340,Ba-Palmas de Monte Alto,202503,9082,3642,4226,16950,20.677,"81,98%","43,92%"
292350,Ba-Palmeiras,202503,5417,1187,976,7580,10.819,"70,06%","50,07%"
292360,Ba-Paramirim,202503,8494,2833,2522,13849,21.009,"65,92%","40,43%"
292370,Ba-Paratinga,202503,19049,3042,3184,25275,30.671,"82,41%","62,11%"
292380,Ba-Paripiranga,202503,12796,3817,2826,19439,27.866,"69,76%","45,92%"
292390,Ba-Pau Brasil,202503,6581,628,1631,8840,9.584,"92,24%","68,67%"
292400,Ba-Paulo Afonso,202503,39125,15091,13104,67320,119.128,"56,51%","32,84%"
292405,Ba-Pe de Serra,202503,7670,1602,2076,11348,13.675,"82,98%","56,09%"
292410,Ba-Pedrao,202503,3691,585,681,4957,6.415,"77,27%","57,54%"
292420,Ba-Pedro Alexandre,202503,9313,1246,1574,12133,14.288,"84,92%","65,18%"
292430,Ba-Piata,202503,7836,3482,3720,15038,20.859,"72,09%","37,57%"
292440,Ba-Pilao Arcado,202503,22245,3769,2493,28507,37.272,"76,48%","59,68%"
292450,Ba-Pindai,202503,6325,2632,3275,12232,15.146,"80,76%","41,76%"
292460,Ba-Pindobacu,202503,11361,1991,2403,15755,19.625,"80,28%","57,89%"
292465,Ba-Pintadas,202503,4069,1343,1138,6550,10.656,"61,47%","38,19%"
292467,Ba-Pirai do Norte,202503,4137,942,683,5762,11.429,"50,42%","36,20%"
292470,Ba-Piripa,202503,4218,1520,1875,7613,9.255,"82,26%","45,58%"
292480,Ba-Piritiba,202503,10181,1532,1757,13470,17.838,"75,51%","57,07%"
292490,Ba-Planaltino,202503,3892,1042,1680,6614,8.254,"80,13%","47,15%"
292500,Ba-Planalto,202503,11229,3486,4725,19440,24.036,"80,88%","46,72%"
292510,Ba-Pocoes,202503,21825,7332,8640,37797,50.642,"74,64%","43,10%"
292520,Ba-Pojuca,202503,11633,4103,4068,19804,33.608,"58,93%","34,61%"
292525,Ba-Ponto Novo,202503,12203,1670,2142,16015,18.670,"85,78%","65,36%"
292530,Ba-Porto Seguro,202503,55921,26622,22888,105431,181.007,"58,25%","30,89%"
292540,Ba-Potiragua,202503,5617,763,1234,7614,10.636,"71,59%","52,81%"
292550,Ba-Prado,202503,13067,6623,4647,24337,37.241,"65,35%","35,09%"
292560,Ba-Presidente Dutra,202503,7757,1927,2232,11916,15.650,"76,14%","49,57%"
292570,Ba-Presidente Janio Quadros,202503,6120,1861,1880,9861,12.986,"75,94%","47,13%"
292575,Ba-Presidente Tancredo Neves,202503,14857,3537,2055,20449,29.343,"69,69%","50,63%"
292580,Ba-Queimadas,202503,13155,2496,2458,18109,27.362,"66,18%","48,08%"
292590,Ba-Quijingue,202503,13991,2783,3620,20394,26.457,"77,08%","52,88%"
292593,Ba-Quixabeira,202503,3967,1418,2130,7515,9.815,"76,57%","40,42%"
292595,Ba-Rafael Jambeiro,202503,10376,2247,2319,14942,20.146,"74,17%","51,50%"
292600,Ba-Remanso,202503,20880,5671,5313,31864,42.746,"74,54%","48,85%"
292610,Ba-Retirolandia,202503,7574,1921,1986,11481,14.147,"81,16%","53,54%"
292620,Ba-Riachao das Neves,202503,11691,3137,2207,17035,22.323,"76,31%","52,37%"
292630,Ba-Riachao do Jacuipe,202503,13887,4113,4920,22920,35.118,"65,27%","39,54%"
292640,Ba-Riacho de Santana,202503,13359,5672,4918,23949,32.103,"74,60%","41,61%"
292650,Ba-Ribeira do Amparo,202503,7785,1520,1220,10525,14.525,"72,46%","53,60%"
292660,Ba-Ribeira do Pombal,202503,20657,6396,4243,31296,56.170,"55,72%","36,78%"
292665,Ba-Ribeirao do Largo,202503,4198,933,1160,6291,10.039,"62,67%","41,82%"
292670,Ba-Rio de Contas,202503,5461,2240,1905,9606,13.627,"70,49%","40,07%"
292680,Ba-Rio do Antonio,202503,6056,2306,1947,10309,13.520,"76,25%","44,79%"
292690,Ba-Rio do Pires,202503,3450,1371,1361,6182,10.801,"57,24%","31,94%"
292700,Ba-Rio Real,202503,16365,5633,5580,27578,36.997,"74,54%","44,23%"
292710,Ba-Rodelas,202503,7926,557,592,9075,10.801,"84,02%","73,38%"
292720,Ba-Ruy Barbosa,202503,12895,3672,3067,19634,29.606,"66,32%","43,56%"
292730,Ba-Salinas da Margarida,202503,9371,1547,1733,12651,15.568,"81,26%","60,19%"
292740,Ba-Salvador,202503,648072,246262,212614,1106948,2.568.928,"43,09%","25,23%"
292750,Ba-Santa Barbara,202503,12332,3283,2983,18598,21.723,"85,61%","56,77%"
292760,Ba-Santa Brigida,202503,7400,2226,2072,11698,15.421,"75,86%","47,99%"
292770,Ba-Santa Cruz Cabralia,202503,12406,4279,4043,20728,30.862,"67,16%","40,20%"
292780,Ba-Santa Cruz da Vitoria,202503,2471,652,931,4054,4.721,"85,87%","52,34%"
292790,Ba-Santa Ines,202503,4970,1329,1695,7994,10.628,"75,22%","46,76%"
292800,Ba-Santaluz,202503,20081,5129,4916,30126,39.922,"75,46%","50,30%"
292805,Ba-Santa Luzia,202503,5627,1494,1539,8660,14.377,"60,24%","39,14%"
292810,Ba-Santa Maria da Vitoria,202503,18868,5335,6210,30413,40.467,"75,16%","46,63%"
292820,Ba-Santana,202503,10913,4284,4136,19333,25.520,"75,76%","42,76%"
292830,Ba-Santanopolis,202503,5175,1163,920,7258,9.023,"80,44%","57,35%"
292840,Ba-Santa Rita de Cassia,202503,17483,2891,3628,24002,28.826,"83,27%","60,65%"
292850,Ba-Santa Teresinha,202503,4422,1642,1241,7305,10.847,"67,35%","40,77%"
292860,Ba-Santo Amaro,202503,26122,6141,5984,38247,58.413,"65,48%","44,72%"
292870,Ba-Santo Antonio de Jesus,202503,30219,14726,12420,57365,109.267,"52,50%","27,66%"
292880,Ba-Santo Estevao,202503,18787,9218,6766,34771,54.940,"63,29%","34,20%"
292890,Ba-Sao Desiderio,202503,14089,4490,3510,22089,34.783,"63,51%","40,51%"
292895,Ba-Sao Domingos,202503,4293,1025,1429,6747,8.693,"77,61%","49,38%"
292900,Ba-Sao Felix,202503,4674,1605,1195,7474,11.198,"66,74%","41,74%"
292905,Ba-Sao Felix do Coribe,202503,7060,2181,2480,11721,15.740,"74,47%","44,85%"
292910,Ba-Sao Felipe,202503,11102,2434,1993,15529,20.918,"74,24%","53,07%"
292920,Ba-Sao Francisco do Conde,202503,17714,5007,4664,27385,40.932,"66,90%","43,28%"
292925,Ba-Sao Gabriel,202503,9142,2967,3087,15196,19.210,"79,10%","47,59%"
292930,Ba-Sao Goncalo dos Campos,202503,10600,6818,5379,22797,41.909,"54,40%","25,29%"
292935,Ba-Sao Jose da Vitoria,202503,3855,726,925,5506,5.451,"101,01%","70,72%"
292937,Ba-Sao Jose do Jacuipe,202503,4298,1851,1224,7373,10.556,"69,85%","40,72%"
292940,Ba-Sao Miguel das Matas,202503,4869,1410,1602,7881,10.634,"74,11%","45,79%"
292950,Ba-Sao Sebastiao do Passe,202503,12706,5651,6005,24362,42.936,"56,74%","29,59%"
292960,Ba-Sapeacu,202503,8479,2617,2713,13809,18.609,"74,21%","45,56%"
292970,Ba-Satiro Dias,202503,8176,2132,1593,11901,16.485,"72,19%","49,60%"
292975,Ba-Saubara,202503,6775,1923,1251,9949,11.842,"84,01%","57,21%"
292980,Ba-Saude,202503,6397,860,1320,8577,10.715,"80,05%","59,70%"
292990,Ba-Seabra,202503,19830,7780,6169,33779,48.530,"69,60%","40,86%"
293000,Ba-Sebastiao Laranjeiras,202503,3970,1280,1231,6481,9.610,"67,44%","41,31%"
293010,Ba-Senhor do Bonfim,202503,29559,9802,10928,50289,77.976,"64,49%","37,91%"
293015,Ba-Serra do Ramalho,202503,15975,5858,5228,27061,36.119,"74,92%","44,23%"
293020,Ba-Sento Se,202503,22896,3399,2720,29015,40.147,"72,27%","57,03%"
293030,Ba-Serra Dourada,202503,7871,3181,3205,14257,17.580,"81,10%","44,77%"
293040,Ba-Serra Preta,202503,7323,2008,2652,11983,18.685,"64,13%","39,19%"
293050,Ba-Serrinha,202503,38043,10395,9937,58375,84.428,"69,14%","45,06%"
293060,Ba-Serrolandia,202503,6082,2178,2354,10614,13.831,"76,74%","43,97%"
293070,Ba-Simoes Filho,202503,45678,15321,14289,75288,120.394,"62,53%","37,94%"
293075,Ba-Sitio do Mato,202503,8471,1477,1292,11240,13.935,"80,66%","60,79%"
293076,Ba-Sitio do Quinto,202503,6547,1188,832,8567,14.359,"59,66%","45,60%"
293077,Ba-Sobradinho,202503,9805,4126,3939,17870,26.959,"66,29%","36,37%"
293080,Ba-Souto Soares,202503,8794,2482,2136,13412,17.674,"75,89%","49,76%"
293090,Ba-Tabocas do Brejo Velho,202503,5139,2254,2260,9653,12.368,"78,05%","41,55%"
293100,Ba-Tanhacu,202503,9925,2685,3295,15905,21.741,"73,16%","45,65%"
293105,Ba-Tanque Novo,202503,8202,2950,2096,13248,17.770,"74,55%","46,16%"
293110,Ba-Tanquinho,202503,3782,1036,1106,5924,7.983,"74,21%","47,38%"
293120,Ba-Taperoa,202503,8834,2036,1573,12443,18.571,"67,00%","47,57%"
293130,Ba-Tapiramuta,202503,7643,1035,1288,9966,16.253,"61,32%","47,03%"
293135,Ba-Teixeira de Freitas,202503,30635,26428,25240,82303,153.332,"53,68%","19,98%"
293140,Ba-Teodoro Sampaio,202503,3676,793,978,5447,7.301,"74,61%","50,35%"
293150,Ba-Teofilandia,202503,8381,3479,3851,15711,21.827,"71,98%","38,40%"
293160,Ba-Teolandia,202503,6940,1304,881,9125,15.919,"57,32%","43,60%"
293170,Ba-Terra Nova,202503,6554,1397,2043,9994,11.035,"90,57%","59,39%"
293180,Ba-Tremedal,202503,8214,2333,2589,13136,16.691,"78,70%","49,21%"
293190,Ba-Tucano,202503,31213,4811,5380,41404,50.959,"81,25%","61,25%"
293200,Ba-Uaua,202503,14312,3126,4131,21569,25.441,"84,78%","56,26%"
293210,Ba-Ubaira,202503,9251,2383,2452,14086,19.162,"73,51%","48,28%"
293220,Ba-Ubaitaba,202503,7881,2595,3334,13810,17.967,"76,86%","43,86%"
293230,Ba-Ubata,202503,6486,1834,2515,10835,16.097,"67,31%","40,29%"
293240,Ba-Uibai,202503,7332,1976,1835,11143,13.880,"80,28%","52,82%"
293245,Ba-Umburanas,202503,7743,1798,1641,11182,13.888,"80,52%","55,75%"
293250,Ba-Una,202503,7457,3134,3371,13962,18.403,"75,87%","40,52%"
293260,Ba-Urandi,202503,7172,2485,2645,12302,15.794,"77,89%","45,41%"
293270,Ba-Urucuca,202503,12220,1817,2475,16512,22.130,"74,61%","55,22%"
293280,Ba-Utinga,202503,8812,1430,1829,12071,16.691,"72,32%","52,79%"
293290,Ba-Valenca,202503,34409,11277,8011,53697,90.028,"59,64%","38,22%"
293300,Ba-Valente,202503,10382,3286,3226,16894,25.126,"67,24%","41,32%"
293305,Ba-Varzea da Roca,202503,7322,1432,2272,11026,14.279,"77,22%","51,28%"
293310,Ba-Varzea do Poco,202503,3956,1038,1007,6001,8.344,"71,92%","47,41%"
293315,Ba-Varzea Nova,202503,7449,1261,1740,10450,13.847,"75,47%","53,80%"
293317,Ba-Varzedo,202503,4473,1238,1114,6825,10.296,"66,29%","43,44%"
293320,Ba-Vera Cruz,202503,24970,4065,4239,33274,44.978,"73,98%","55,52%"
293325,Ba-Vereda,202503,2538,1081,996,4615,6.171,"74,79%","41,13%"
293330,Ba-Vitoria da Conquista,202503,110689,62235,61203,234127,394.024,"59,42%","28,09%"
293340,Ba-Wagner,202503,3744,1299,1395,6438,9.847,"65,38%","38,02%"
293345,Ba-Wanderley,202503,5421,2537,2043,10001,13.436,"74,43%","40,35%"
293350,Ba-Wenceslau Guimaraes,202503,11551,2760,1857,16168,25.430,"63,58%","45,42%"
293360,Ba-Xique-Xique,202503,28071,4762,5096,37929,46.979,"80,74%","59,75%"
310010,Mg-Abadia dos Dourados,202503,1003,630,627,2260,6.365,"35,51%","15,76%"
310020,Mg-Abaete,202503,3764,2777,3179,9720,23.161,"41,97%","16,25%"
310030,Mg-Abre Campo,202503,3485,1227,1172,5884,14.312,"41,11%","24,35%"
310040,Mg-Acaiaca,202503,1064,563,671,2298,3.997,"57,49%","26,62%"
310050,Mg-Acucena,202503,2404,1346,1184,4934,8.995,"54,85%","26,73%"
310060,Mg-Agua Boa,202503,4883,2034,1582,8499,12.545,"67,75%","38,92%"
310070,Mg-Agua Comprida,202503,525,148,197,870,2.165,"40,18%","24,25%"
310080,Mg-Aguanil,202503,915,685,602,2202,4.490,"49,04%","20,38%"
310090,Mg-Aguas Formosas,202503,8002,2444,2685,13131,18.841,"69,69%","42,47%"
310100,Mg-Aguas Vermelhas,202503,6399,1780,1882,10061,14.486,"69,45%","44,17%"
310110,Mg-Aimores,202503,5779,3406,3415,12600,26.165,"48,16%","22,09%"
310120,Mg-Aiuruoca,202503,543,667,587,1797,6.382,"28,16%","8,51%"
310130,Mg-Alagoa,202503,813,231,213,1257,2.816,"44,64%","28,87%"
310140,Mg-Albertina,202503,630,338,201,1169,3.023,"38,67%","20,84%"
310150,Mg-Alem Paraiba,202503,6968,4419,5280,16667,31.333,"53,19%","22,24%"
310160,Mg-Alfenas,202503,12630,8202,9293,30125,81.950,"36,76%","15,41%"
310163,Mg-Alfredo Vasconcelos,202503,952,1544,1276,3772,7.184,"52,51%","13,25%"
310170,Mg-Almenara,202503,13835,5612,5589,25036,41.894,"59,76%","33,02%"
310180,Mg-Alpercata,202503,2390,1022,1485,4897,7.029,"69,67%","34,00%"
310190,Mg-Alpinopolis,202503,2534,2592,1960,7086,18.672,"37,95%","13,57%"
310200,Mg-Alterosa,202503,2938,1615,1524,6077,14.253,"42,64%","20,61%"
310205,Mg-Alto Caparao,202503,1863,973,1044,3880,5.982,"64,86%","31,14%"
310210,Mg-Alto Rio Doce,202503,3380,1505,1626,6511,10.994,"59,22%","30,74%"
310220,Mg-Alvarenga,202503,1542,782,919,3243,4.012,"80,83%","38,43%"
310230,Mg-Alvinopolis,202503,3122,1673,1733,6528,15.360,"42,50%","20,33%"
310240,Mg-Alvorada de Minas,202503,1660,795,758,3213,4.322,"74,34%","38,41%"
310250,Mg-Amparo do Serra,202503,1648,649,575,2872,4.595,"62,50%","35,87%"
310260,Mg-Andradas,202503,2948,4205,4628,11781,42.282,"27,86%","6,97%"
310270,Mg-Cachoeira de Pajeu,202503,3810,1027,1190,6027,9.333,"64,58%","40,82%"
310280,Mg-Andrelandia,202503,2790,1875,1944,6609,12.169,"54,31%","22,93%"
310285,Mg-Angelandia,202503,2897,1658,1265,5820,7.860,"74,05%","36,86%"
310290,Mg-Antonio Carlos,202503,2229,1402,1449,5080,11.345,"44,78%","19,65%"
310300,Mg-Antonio Dias,202503,1656,1655,2014,5325,9.388,"56,72%","17,64%"
310310,Mg-Antonio Prado de Minas,202503,314,177,311,802,1.558,"51,48%","20,15%"
310320,Mg-Aracai,202503,492,307,541,1340,2.224,"60,25%","22,12%"
310330,Mg-Aracitaba,202503,474,335,617,1426,2.095,"68,07%","22,63%"
310340,Mg-Aracuai,202503,8314,6405,7347,22066,35.250,"62,60%","23,59%"
310350,Mg-Araguari,202503,14851,10441,12223,37515,122.874,"30,53%","12,09%"
310360,Mg-Arantina,202503,959,278,326,1563,2.991,"52,26%","32,06%"
310370,Mg-Araponga,202503,2015,1614,765,4394,8.218,"53,47%","24,52%"
310375,Mg-Arapora,202503,1193,733,767,2693,8.935,"30,14%","13,35%"
310380,Mg-Arapua,202503,299,235,329,863,2.674,"32,27%","11,18%"
310390,Mg-Araujos,202503,1151,758,549,2458,9.556,"25,72%","12,04%"
310400,Mg-Araxa,202503,12591,10512,11756,34859,117.677,"29,62%","10,70%"
310410,Mg-Arceburgo,202503,741,1061,1391,3193,9.348,"34,16%","7,93%"
310420,Mg-Arcos,202503,5268,4197,5781,15246,43.348,"35,17%","12,15%"
310430,Mg-Areado,202503,2185,1553,1838,5576,14.212,"39,23%","15,37%"
310440,Mg-Argirita,202503,700,453,769,1922,2.725,"70,53%","25,69%"
310445,Mg-Aricanduva,202503,2069,742,959,3770,4.820,"78,22%","42,93%"
310450,Mg-Arinos,202503,4930,2957,3342,11229,17.598,"63,81%","28,01%"
310460,Mg-Astolfo Dutra,202503,1690,1965,1667,5322,14.565,"36,54%","11,60%"
310470,Mg-Ataleia,202503,4322,1682,1782,7786,13.967,"55,75%","30,94%"
310480,Mg-Augusto de Lima,202503,1050,819,891,2760,4.593,"60,09%","22,86%"
310490,Mg-Baependi,202503,3052,2809,2332,8193,18.768,"43,65%","16,26%"
310500,Mg-Baldim,202503,2053,1240,1061,4354,7.614,"57,18%","26,96%"
310510,Mg-Bambui,202503,2610,1950,2097,6657,24.144,"27,57%","10,81%"
310520,Mg-Bandeira,202503,1013,926,1419,3358,4.821,"69,65%","21,01%"
310530,Mg-Bandeira do Sul,202503,445,918,949,2312,6.146,"37,62%","7,24%"
310540,Mg-Barao de Cocais,202503,3117,3209,2703,9029,32.095,"28,13%","9,71%"
310550,Mg-Barao de Monte Alto,202503,1254,922,1098,3274,4.991,"65,60%","25,13%"
310560,Mg-Barbacena,202503,18737,14735,18488,51960,129.630,"40,08%","14,45%"
310570,Mg-Barra Longa,202503,1408,901,864,3173,5.740,"55,28%","24,53%"
310590,Mg-Barroso,202503,4809,3142,4336,12287,20.566,"59,74%","23,38%"
310600,Mg-Bela Vista de Minas,202503,1732,1235,1601,4568,10.412,"43,87%","16,63%"
310610,Mg-Belmiro Braga,202503,277,594,637,1508,3.299,"45,71%","8,40%"
310620,Mg-Belo Horizonte,202503,266953,184664,225758,677375,2.416.339,"28,03%","11,05%"
310630,Mg-Belo Oriente,202503,5113,3456,4958,13527,24.503,"55,21%","20,87%"
310640,Mg-Belo Vale,202503,2140,929,1318,4387,8.946,"49,04%","23,92%"
310650,Mg-Berilo,202503,2921,1670,2114,6705,9.769,"68,64%","29,90%"
310660,Mg-Bertopolis,202503,2320,887,814,4021,4.546,"88,45%","51,03%"
310665,Mg-Berizal,202503,2548,451,633,3632,4.277,"84,92%","59,57%"
310670,Mg-Betim,202503,72264,51679,58124,182067,429.236,"42,42%","16,84%"
310680,Mg-Bias Fortes,202503,980,435,487,1902,3.388,"56,14%","28,93%"
310690,Mg-Bicas,202503,3241,1683,2026,6950,14.331,"48,50%","22,62%"
310700,Mg-Biquinhas,202503,625,199,281,1105,2.409,"45,87%","25,94%"
310710,Mg-Boa Esperanca,202503,5460,7484,6810,19754,41.332,"47,79%","13,21%"
310720,Mg-Bocaina de Minas,202503,1660,676,600,2936,5.508,"53,30%","30,14%"
310730,Mg-Bocaiuva,202503,15033,6169,6847,28049,49.668,"56,47%","30,27%"
310740,Mg-Bom Despacho,202503,8134,5722,5467,19323,53.995,"35,79%","15,06%"
310750,Mg-Bom Jardim de Minas,202503,1396,1022,1063,3481,6.968,"49,96%","20,03%"
310760,Mg-Bom Jesus da Penha,202503,927,494,573,1994,4.642,"42,96%","19,97%"
310770,Mg-Bom Jesus do Amparo,202503,1174,1069,922,3165,5.775,"54,81%","20,33%"
310780,Mg-Bom Jesus do Galho,202503,4865,2145,2247,9257,14.756,"62,73%","32,97%"
310790,Mg-Bom Repouso,202503,2806,2599,1283,6688,13.183,"50,73%","21,28%"
310800,Mg-Bom Sucesso,202503,1137,3323,2546,7006,17.510,"40,01%","6,49%"
310810,Mg-Bonfim,202503,2029,875,859,3763,7.672,"49,05%","26,45%"
310820,Mg-Bonfinopolis de Minas,202503,1005,830,1230,3065,5.615,"54,59%","17,90%"
310825,Mg-Bonito de Minas,202503,4709,1456,1631,7796,10.491,"74,31%","44,89%"
310830,Mg-Borda da Mata,202503,3035,1929,2156,7120,17.811,"39,98%","17,04%"
310840,Mg-Botelhos,202503,2264,2121,1784,6169,15.137,"40,75%","14,96%"
310850,Mg-Botumirim,202503,1896,973,937,3806,5.841,"65,16%","32,46%"
310855,Mg-Brasilandia de Minas,202503,4327,2361,2562,9250,15.432,"59,94%","28,04%"
310860,Mg-Brasilia de Minas,202503,10728,5582,4665,20975,33.188,"63,20%","32,32%"
310870,Mg-Bras Pires,202503,1393,495,494,2382,4.314,"55,22%","32,29%"
310880,Mg-Braunas,202503,1269,593,929,2791,4.475,"62,37%","28,36%"
310890,Mg-Brasopolis,202503,1103,2707,1997,5807,14.506,"40,03%","7,60%"
310900,Mg-Brumadinho,202503,4483,4481,5259,14223,40.777,"34,88%","10,99%"
310910,Mg-Bueno Brandao,202503,1228,2648,2016,5892,11.161,"52,79%","11,00%"
310920,Mg-Buenopolis,202503,2538,1313,1163,5014,9.229,"54,33%","27,50%"
310925,Mg-Bugre,202503,1332,610,934,2876,4.149,"69,32%","32,10%"
310930,Mg-Buritis,202503,5955,4463,5153,15571,24.693,"63,06%","24,12%"
310940,Mg-Buritizeiro,202503,10621,2700,4054,17375,24.068,"72,19%","44,13%"
310945,Mg-Cabeceira Grande,202503,1474,920,1249,3643,6.797,"53,60%","21,69%"
310950,Mg-Cabo Verde,202503,1240,2382,2159,5781,11.396,"50,73%","10,88%"
310960,Mg-Cachoeira da Prata,202503,495,581,911,1987,3.781,"52,55%","13,09%"
310970,Mg-Cachoeira de Minas,202503,957,1474,1150,3581,12.248,"29,24%","7,81%"
310980,Mg-Cachoeira Dourada,202503,270,270,447,987,2.346,"42,07%","11,51%"
310990,Mg-Caetanopolis,202503,1827,1275,1054,4156,11.832,"35,13%","15,44%"
311000,Mg-Caete,202503,5382,3775,3359,12516,39.850,"31,41%","13,51%"
311010,Mg-Caiana,202503,1575,792,836,3203,5.463,"58,63%","28,83%"
311020,Mg-Cajuri,202503,1204,906,1115,3225,4.186,"77,04%","28,76%"
311030,Mg-Caldas,202503,2002,1446,1651,5099,14.588,"34,95%","13,72%"
311040,Mg-Camacho,202503,434,317,309,1060,2.867,"36,97%","15,14%"
311050,Mg-Camanducaia,202503,3568,2427,2571,8566,27.551,"31,09%","12,95%"
311060,Mg-Cambui,202503,3162,3162,3623,9947,30.870,"32,22%","10,24%"
311070,Mg-Cambuquira,202503,2382,2001,2210,6593,12.560,"52,49%","18,96%"
311080,Mg-Campanario,202503,1147,556,543,2246,2.917,"77,00%","39,32%"
311090,Mg-Campanha,202503,2506,2982,2128,7616,16.334,"46,63%","15,34%"
311100,Mg-Campestre,202503,2504,2528,2259,7291,21.143,"34,48%","11,84%"
311110,Mg-Campina Verde,202503,1415,2739,5071,9225,18.250,"50,55%","7,75%"
311115,Mg-Campo Azul,202503,1789,574,413,2776,3.802,"73,01%","47,05%"
311120,Mg-Campo Belo,202503,7491,6191,7288,20970,53.943,"38,87%","13,89%"
311130,Mg-Campo do Meio,202503,2475,1547,1482,5504,11.624,"47,35%","21,29%"
311140,Mg-Campo Florido,202503,2007,1171,1908,5086,8.838,"57,55%","22,71%"
311150,Mg-Campos Altos,202503,1971,1575,1033,4579,13.136,"34,86%","15,00%"
311160,Mg-Campos Gerais,202503,4302,4166,4091,12559,26.809,"46,85%","16,05%"
311170,Mg-Canaa,202503,1745,574,548,2867,4.832,"59,33%","36,11%"
311180,Mg-Canapolis,202503,1172,1141,1720,4033,10.755,"37,50%","10,90%"
311190,Mg-Cana Verde,202503,927,831,715,2473,5.356,"46,17%","17,31%"
311200,Mg-Candeias,202503,2097,2253,2154,6504,14.236,"45,69%","14,73%"
311205,Mg-Cantagalo,202503,1209,936,807,2952,4.039,"73,09%","29,93%"
311210,Mg-Caparao,202503,2186,665,418,3269,5.144,"63,55%","42,50%"
311220,Mg-Capela Nova,202503,1376,456,387,2219,4.416,"50,25%","31,16%"
311230,Mg-Capelinha,202503,7661,10124,7909,25694,41.536,"61,86%","18,44%"
311240,Mg-Capetinga,202503,1482,861,725,3068,6.652,"46,12%","22,28%"
311250,Mg-Capim Branco,202503,1790,1367,1511,4668,11.105,"42,04%","16,12%"
311260,Mg-Capinopolis,202503,2087,1746,2853,6686,14.899,"44,88%","14,01%"
311265,Mg-Capitao Andrade,202503,1512,580,794,2886,4.650,"62,06%","32,52%"
311270,Mg-Capitao Eneas,202503,4980,2558,2172,9710,14.401,"67,43%","34,58%"
311280,Mg-Capitolio,202503,934,1343,1595,3872,10.863,"35,64%","8,60%"
311290,Mg-Caputira,202503,3372,1545,1016,5933,9.128,"65,00%","36,94%"
311300,Mg-Carai,202503,6969,2773,2307,12049,19.654,"61,31%","35,46%"
311310,Mg-Caranaiba,202503,723,262,395,1380,2.960,"46,62%","24,43%"
311320,Mg-Carandai,202503,3679,3492,2890,10061,24.368,"41,29%","15,10%"
311330,Mg-Carangola,202503,6948,4290,4783,16021,32.165,"49,81%","21,60%"
311340,Mg-Caratinga,202503,9696,12412,9027,31135,90.687,"34,33%","10,69%"
311350,Mg-Carbonita,202503,1876,1723,1899,5498,8.633,"63,69%","21,73%"
311360,Mg-Careacu,202503,1126,968,891,2985,7.029,"42,47%","16,02%"
311370,Mg-Carlos Chagas,202503,4592,3251,3652,11495,18.852,"60,97%","24,36%"
311380,Mg-Carmesia,202503,586,417,433,1436,2.682,"53,54%","21,85%"
311390,Mg-Carmo da Cachoeira,202503,2044,2239,1275,5558,11.776,"47,20%","17,36%"
311400,Mg-Carmo da Mata,202503,1705,1270,1721,4696,11.279,"41,63%","15,12%"
311410,Mg-Carmo de Minas,202503,2213,2333,1821,6367,14.114,"45,11%","15,68%"
311420,Mg-Carmo do Cajuru,202503,1376,2004,1572,4952,24.376,"20,32%","5,64%"
311430,Mg-Carmo do Paranaiba,202503,3564,3829,4711,12104,29.899,"40,48%","11,92%"
311440,Mg-Carmo do Rio Claro,202503,1291,4893,2901,9085,21.464,"42,33%","6,01%"
311450,Mg-Carmopolis de Minas,202503,2701,2687,3451,8839,18.498,"47,78%","14,60%"
311455,Mg-Carneirinho,202503,1122,613,930,2665,9.630,"27,67%","11,65%"
311460,Mg-Carrancas,202503,379,709,886,1974,4.153,"47,53%","9,13%"
311470,Mg-Carvalhopolis,202503,364,577,552,1493,3.417,"43,69%","10,65%"
311480,Mg-Carvalhos,202503,1449,419,536,2404,4.507,"53,34%","32,15%"
311490,Mg-Casa Grande,202503,388,333,267,988,2.260,"43,72%","17,17%"
311500,Mg-Cascalho Rico,202503,575,399,474,1448,2.757,"52,52%","20,86%"
311510,Mg-Cassia,202503,3598,2484,2610,8692,17.495,"49,68%","20,57%"
311520,Mg-Conceicao da Barra de Minas,202503,1028,464,394,1886,3.596,"52,45%","28,59%"
311530,Mg-Cataguases,202503,8890,7072,8539,24501,67.872,"36,10%","13,10%"
311535,Mg-Catas Altas,202503,1146,679,1371,3196,5.668,"56,39%","20,22%"
311540,Mg-Catas Altas da Noruega,202503,959,384,289,1632,3.141,"51,96%","30,53%"
311545,Mg-Catuji,202503,3557,1425,1150,6132,7.226,"84,86%","49,23%"
311547,Mg-Catuti,202503,2639,683,849,4171,4.805,"86,81%","54,92%"
311550,Mg-Caxambu,202503,3303,2801,2035,8139,21.436,"37,97%","15,41%"
311560,Mg-Cedro do Abaete,202503,202,167,242,611,1.091,"56,00%","18,52%"
311570,Mg-Central de Minas,202503,1623,767,880,3270,6.243,"52,38%","26,00%"
311580,Mg-Centralina,202503,1944,990,1304,4238,10.440,"40,59%","18,62%"
311590,Mg-Chacara,202503,874,587,408,1869,3.177,"58,83%","27,51%"
311600,Mg-Chale,202503,2524,696,486,3706,6.261,"59,19%","40,31%"
311610,Mg-Chapada do Norte,202503,3383,1773,2097,7253,10.024,"72,36%","33,75%"
311615,Mg-Chapada Gaucha,202503,5863,1897,2025,9785,12.810,"76,39%","45,77%"
311620,Mg-Chiador,202503,698,547,646,1891,2.865,"66,00%","24,36%"
311630,Mg-Cipotanea,202503,1717,959,1181,3857,5.599,"68,89%","30,67%"
311640,Mg-Claraval,202503,1009,561,745,2315,4.777,"48,46%","21,12%"
311650,Mg-Claro dos Pocoes,202503,2303,1369,1307,4979,7.259,"68,59%","31,73%"
311660,Mg-Claudio,202503,2554,3567,4048,10169,31.665,"32,11%","8,07%"
311670,Mg-Coimbra,202503,1475,1286,1385,4146,7.285,"56,91%","20,25%"
311680,Mg-Coluna,202503,3428,1306,1627,6361,8.251,"77,09%","41,55%"
311690,Mg-Comendador Gomes,202503,529,437,442,1408,2.813,"50,05%","18,81%"
311700,Mg-Comercinho,202503,3042,933,1192,5167,6.627,"77,97%","45,90%"
311710,Mg-Conceicao da Aparecida,202503,1571,1962,1373,4906,10.668,"45,99%","14,73%"
311720,Mg-Conceicao das Pedras,202503,936,208,293,1437,2.837,"50,65%","32,99%"
311730,Mg-Conceicao das Alagoas,202503,4997,3406,4702,13105,29.949,"43,76%","16,69%"
311740,Mg-Conceicao de Ipanema,202503,1902,571,518,2991,4.503,"66,42%","42,24%"
311750,Mg-Conceicao do Mato Dentro,202503,4556,3268,3587,11411,24.254,"47,05%","18,78%"
311760,Mg-Conceicao do Para,202503,794,804,1038,2636,5.567,"47,35%","14,26%"
311770,Mg-Conceicao do Rio Verde,202503,2238,2393,2020,6651,12.780,"52,04%","17,51%"
311780,Mg-Conceicao dos Ouros,202503,1567,1699,1687,4953,11.183,"44,29%","14,01%"
311783,Mg-Conego Marinho,202503,3486,1051,1514,6051,7.420,"81,55%","46,98%"
311787,Mg-Confins,202503,527,968,929,2424,7.676,"31,58%","6,87%"
311790,Mg-Congonhal,202503,1407,1692,1617,4716,11.403,"41,36%","12,34%"
311800,Mg-Congonhas,202503,4859,5664,8156,18679,54.986,"33,97%","8,84%"
311810,Mg-Congonhas do Norte,202503,1631,576,701,2908,4.927,"59,02%","33,10%"
311820,Mg-Conquista,202503,1229,660,1209,3098,6.864,"45,13%","17,91%"
311830,Mg-Conselheiro Lafaiete,202503,8739,11297,10347,30383,137.980,"22,02%","6,33%"
311840,Mg-Conselheiro Pena,202503,5254,2587,2595,10436,21.113,"49,43%","24,89%"
311850,Mg-Consolacao,202503,509,255,209,973,1.578,"61,66%","32,26%"
311860,Mg-Contagem,202503,97449,54022,65104,216575,649.975,"33,32%","14,99%"
311870,Mg-Coqueiral,202503,1925,1570,1428,4923,9.197,"53,53%","20,93%"
311880,Mg-Coracao de Jesus,202503,9505,3875,3422,16802,26.151,"64,25%","36,35%"
311890,Mg-Cordisburgo,202503,2449,979,1182,4610,7.592,"60,72%","32,26%"
311900,Mg-Cordislandia,202503,1020,510,411,1941,3.247,"59,78%","31,41%"
311910,Mg-Corinto,202503,5834,3261,2630,11725,23.996,"48,86%","24,31%"
311920,Mg-Coroaci,202503,2703,1211,1171,5085,11.200,"45,40%","24,13%"
311930,Mg-Coromandel,202503,5034,2948,3557,11539,30.013,"38,45%","16,77%"
311940,Mg-Coronel Fabriciano,202503,12577,11517,14239,38333,108.551,"35,31%","11,59%"
311950,Mg-Coronel Murta,202503,3249,1440,1787,6476,8.283,"78,18%","39,22%"
311960,Mg-Coronel Pacheco,202503,379,447,549,1375,2.799,"49,12%","13,54%"
311970,Mg-Coronel Xavier Chaves,202503,281,682,469,1432,3.586,"39,93%","7,84%"
311980,Mg-Corrego Danta,202503,340,356,633,1329,2.978,"44,63%","11,42%"
311990,Mg-Corrego do Bom Jesus,202503,411,420,460,1291,4.429,"29,15%","9,28%"
311995,Mg-Corrego Fundo,202503,274,743,2082,3099,6.310,"49,11%","4,34%"
312000,Mg-Corrego Novo,202503,936,421,416,1773,2.912,"60,89%","32,14%"
312010,Mg-Couto de Magalhaes de Minas,202503,1536,728,1014,3278,4.346,"75,43%","35,34%"
312015,Mg-Crisolita,202503,2239,782,573,3594,5.296,"67,86%","42,28%"
312020,Mg-Cristais,202503,1708,2369,2411,6488,12.576,"51,59%","13,58%"
312030,Mg-Cristalia,202503,3270,867,955,5092,5.165,"98,59%","63,31%"
312040,Mg-Cristiano Otoni,202503,815,749,653,2217,4.735,"46,82%","17,21%"
312050,Mg-Cristina,202503,1529,1687,794,4010,10.627,"37,73%","14,39%"
312060,Mg-Crucilandia,202503,768,979,883,2630,5.633,"46,69%","13,63%"
312070,Mg-Cruzeiro da Fortaleza,202503,959,719,1036,2714,3.610,"75,18%","26,57%"
312080,Mg-Cruzilia,202503,3609,2153,1998,7760,15.779,"49,18%","22,87%"
312083,Mg-Cuparaque,202503,1350,650,552,2552,3.994,"63,90%","33,80%"
312087,Mg-Curral de Dentro,202503,4194,989,1118,6301,7.630,"82,58%","54,97%"
312090,Mg-Curvelo,202503,13804,10403,10003,34210,83.862,"40,79%","16,46%"
312100,Mg-Datas,202503,2467,1046,1234,4747,5.618,"84,50%","43,91%"
312110,Mg-Delfim Moreira,202503,1694,978,655,3327,8.130,"40,92%","20,84%"
312120,Mg-Delfinopolis,202503,1087,1105,1157,3349,8.760,"38,23%","12,41%"
312125,Mg-Delta,202503,3035,1139,1061,5235,11.003,"47,58%","27,58%"
312130,Mg-Descoberto,202503,1155,903,1018,3076,5.058,"60,81%","22,84%"
312140,Mg-Desterro de Entre Rios,202503,712,1021,806,2539,7.900,"32,14%","9,01%"
312150,Mg-Desterro do Melo,202503,846,427,466,1739,3.059,"56,85%","27,66%"
312160,Mg-Diamantina,202503,9893,8623,9867,28383,49.353,"57,51%","20,05%"
312170,Mg-Diogo de Vasconcelos,202503,1069,566,612,2247,3.596,"62,49%","29,73%"
312180,Mg-Dionisio,202503,1723,1010,965,3698,6.789,"54,47%","25,38%"
312190,Mg-Divinesia,202503,943,799,673,2415,4.426,"54,56%","21,31%"
312200,Mg-Divino,202503,5974,3992,3222,13188,21.329,"61,83%","28,01%"
312210,Mg-Divino das Laranjeiras,202503,1582,534,714,2830,4.186,"67,61%","37,79%"
312220,Mg-Divinolandia de Minas,202503,2824,1168,945,4937,6.607,"74,72%","42,74%"
312230,Mg-Divinopolis,202503,21376,20874,25101,67351,242.328,"27,79%","8,82%"
312235,Mg-Divisa Alegre,202503,2952,1141,1207,5300,6.513,"81,38%","45,32%"
312240,Mg-Divisa Nova,202503,831,1072,772,2675,5.993,"44,64%","13,87%"
312245,Mg-Divisopolis,202503,5384,662,1074,7120,10.585,"67,26%","50,86%"
312247,Mg-Dom Bosco,202503,892,553,844,2289,3.767,"60,76%","23,68%"
312250,Mg-Dom Cavati,202503,684,888,907,2479,4.981,"49,77%","13,73%"
312260,Mg-Dom Joaquim,202503,1459,615,723,2797,5.051,"55,38%","28,89%"
312270,Mg-Dom Silverio,202503,988,603,863,2454,5.350,"45,87%","18,47%"
312280,Mg-Dom Vicoso,202503,657,531,242,1430,3.176,"45,03%","20,69%"
312290,Mg-Dona Euzebia,202503,1012,1364,794,3170,6.241,"50,79%","16,22%"
312300,Mg-Dores de Campos,202503,1164,1534,1218,3916,10.313,"37,97%","11,29%"
312310,Mg-Dores de Guanhaes,202503,1610,780,899,3289,5.121,"64,23%","31,44%"
312320,Mg-Dores do Indaia,202503,1515,1825,2113,5453,12.786,"42,65%","11,85%"
312330,Mg-Dores do Turvo,202503,1256,793,630,2679,5.159,"51,93%","24,35%"
312340,Mg-Doresopolis,202503,292,165,182,639,1.496,"42,71%","19,52%"
312350,Mg-Douradoquara,202503,237,192,125,554,1.869,"29,64%","12,68%"
312352,Mg-Durande,202503,2864,1309,700,4873,8.038,"60,62%","35,63%"
312360,Mg-Eloi Mendes,202503,4006,3294,3458,10758,27.343,"39,34%","14,65%"
312370,Mg-Engenheiro Caldas,202503,2479,1469,1632,5580,14.308,"39,00%","17,33%"
312380,Mg-Engenheiro Navarro,202503,2587,1146,1184,4917,6.411,"76,70%","40,35%"
312385,Mg-Entre Folhas,202503,1820,953,1010,3783,5.293,"71,47%","34,39%"
312390,Mg-Entre Rios de Minas,202503,1739,2298,2133,6170,15.120,"40,81%","11,50%"
312400,Mg-Ervalia,202503,3917,3918,2146,9981,20.951,"47,64%","18,70%"
312410,Mg-Esmeraldas,202503,22744,11936,12222,46902,91.573,"51,22%","24,84%"
312420,Mg-Espera Feliz,202503,5591,3830,2938,12359,24.761,"49,91%","22,58%"
312430,Mg-Espinosa,202503,11379,5051,5321,21751,31.385,"69,30%","36,26%"
312440,Mg-Espirito Santo do Dourado,202503,2292,957,658,3907,7.007,"55,76%","32,71%"
312450,Mg-Estiva,202503,1731,1425,1458,4614,11.836,"38,98%","14,62%"
312460,Mg-Estrela Dalva,202503,605,285,311,1201,2.204,"54,49%","27,45%"
312470,Mg-Estrela do Indaia,202503,286,428,478,1192,2.750,"43,35%","10,40%"
312480,Mg-Estrela do Sul,202503,1163,807,809,2779,6.926,"40,12%","16,79%"
312490,Mg-Eugenopolis,202503,2784,1761,1794,6339,11.075,"57,24%","25,14%"
312500,Mg-Ewbank da Camara,202503,1203,660,646,2509,3.977,"63,09%","30,25%"
312510,Mg-Extrema,202503,3173,5406,9156,17735,57.913,"30,62%","5,48%"
312520,Mg-Fama,202503,458,265,317,1040,2.662,"39,07%","17,21%"
312530,Mg-Faria Lemos,202503,1150,349,415,1914,3.239,"59,09%","35,50%"
312540,Mg-Felicio dos Santos,202503,1748,1079,1404,4231,5.248,"80,62%","33,31%"
312550,Mg-Sao Goncalo do Rio Preto,202503,847,520,877,2244,3.098,"72,43%","27,34%"
312560,Mg-Felisburgo,202503,2745,1158,1160,5063,6.592,"76,81%","41,64%"
312570,Mg-Felixlandia,202503,2952,2004,2265,7221,14.279,"50,57%","20,67%"
312580,Mg-Fernandes Tourinho,202503,550,539,885,1974,2.825,"69,88%","19,47%"
312590,Mg-Ferros,202503,1812,1486,1175,4473,9.666,"46,28%","18,75%"
312595,Mg-Fervedouro,202503,3435,2064,1278,6777,10.693,"63,38%","32,12%"
312600,Mg-Florestal,202503,948,997,1718,3663,8.386,"43,68%","11,30%"
312610,Mg-Formiga,202503,4667,6585,8044,19296,70.668,"27,31%","6,60%"
312620,Mg-Formoso,202503,3772,1096,1482,6350,8.103,"78,37%","46,55%"
312630,Mg-Fortaleza de Minas,202503,397,280,298,975,3.485,"27,98%","11,39%"
312640,Mg-Fortuna de Minas,202503,637,522,511,1670,3.207,"52,07%","19,86%"
312650,Mg-Francisco Badaro,202503,2408,1018,1900,5326,7.208,"73,89%","33,41%"
312660,Mg-Francisco Dumont,202503,1751,788,739,3278,4.564,"71,82%","38,37%"
312670,Mg-Francisco Sa,202503,9046,2934,3668,15648,23.819,"65,70%","37,98%"
312675,Mg-Franciscopolis,202503,1787,704,510,3001,5.062,"59,28%","35,30%"
312680,Mg-Frei Gaspar,202503,2602,772,657,4031,5.741,"70,21%","45,32%"
312690,Mg-Frei Inocencio,202503,3103,1307,1735,6145,8.334,"73,73%","37,23%"
312695,Mg-Frei Lagonegro,202503,1843,431,514,2788,3.475,"80,23%","53,04%"
312700,Mg-Fronteira,202503,2615,1665,2168,6448,14.909,"43,25%","17,54%"
312705,Mg-Fronteira dos Vales,202503,3022,252,537,3811,4.405,"86,52%","68,60%"
312707,Mg-Fruta de Leite,202503,1758,980,1282,4020,4.607,"87,26%","38,16%"
312710,Mg-Frutal,202503,7054,6477,7557,21088,60.942,"34,60%","11,57%"
312720,Mg-Funilandia,202503,1204,811,756,2771,4.886,"56,71%","24,64%"
312730,Mg-Galileia,202503,2003,785,957,3745,6.281,"59,62%","31,89%"
312733,Mg-Gameleiras,202503,1825,879,1230,3934,4.863,"80,90%","37,53%"
312735,Mg-Glaucilandia,202503,873,607,763,2243,2.991,"74,99%","29,19%"
312737,Mg-Goiabeira,202503,932,406,482,1820,2.869,"63,44%","32,49%"
312738,Mg-Goiana,202503,805,763,877,2445,4.190,"58,35%","19,21%"
312740,Mg-Goncalves,202503,380,470,493,1343,4.891,"27,46%","7,77%"
312750,Mg-Gonzaga,202503,1716,1114,1024,3854,5.271,"73,12%","32,56%"
312760,Mg-Gouvea,202503,1910,1992,1705,5607,11.549,"48,55%","16,54%"
312770,Mg-Governador Valadares,202503,34397,32645,43644,110686,266.649,"41,51%","12,90%"
312780,Mg-Grao Mogol,202503,3915,2103,1841,7859,14.091,"55,77%","27,78%"
312790,Mg-Grupiara,202503,60,185,296,541,1.426,"37,94%","4,21%"
312800,Mg-Guanhaes,202503,8385,4158,4382,16925,33.434,"50,62%","25,08%"
312810,Mg-Guape,202503,1852,1486,1532,4870,14.073,"34,61%","13,16%"
312820,Mg-Guaraciaba,202503,2419,1125,1325,4869,9.921,"49,08%","24,38%"
312825,Mg-Guaraciama,202503,2143,654,987,3784,5.203,"72,73%","41,19%"
312830,Mg-Guaranesia,202503,2361,2074,2267,6702,19.611,"34,17%","12,04%"
312840,Mg-Guarani,202503,1442,1361,1118,3921,7.780,"50,40%","18,53%"
312850,Mg-Guarara,202503,967,667,806,2440,3.132,"77,91%","30,87%"
312860,Mg-Guarda-Mor,202503,1155,898,1098,3151,6.684,"47,14%","17,28%"
312870,Mg-Guaxupe,202503,4551,5575,6681,16807,52.621,"31,94%","8,65%"
312880,Mg-Guidoval,202503,2117,977,981,4075,7.284,"55,94%","29,06%"
312890,Mg-Guimarania,202503,2354,1339,1928,5621,8.808,"63,82%","26,73%"
312900,Mg-Guiricema,202503,1577,1091,1063,3731,7.850,"47,53%","20,09%"
312910,Mg-Gurinhata,202503,1113,521,858,2492,5.203,"47,90%","21,39%"
312920,Mg-Heliodora,202503,646,1178,837,2661,6.274,"42,41%","10,30%"
312930,Mg-Iapu,202503,2873,1488,1941,6302,12.486,"50,47%","23,01%"
312940,Mg-Ibertioga,202503,1268,848,665,2781,5.334,"52,14%","23,77%"
312950,Mg-Ibia,202503,3949,1986,2339,8274,22.596,"36,62%","17,48%"
312960,Mg-Ibiai,202503,2820,1131,1009,4960,6.254,"79,31%","45,09%"
312965,Mg-Ibiracatu,202503,2190,1161,1289,4640,5.139,"90,29%","42,62%"
312970,Mg-Ibiraci,202503,2545,1436,1235,5216,11.057,"47,17%","23,02%"
312980,Mg-Ibirite,202503,26391,24783,24268,75442,178.713,"42,21%","14,77%"
312990,Mg-Ibitiura de Minas,202503,507,410,478,1395,3.439,"40,56%","14,74%"
313000,Mg-Ibituruna,202503,590,466,389,1445,2.740,"52,74%","21,53%"
313005,Mg-Icarai de Minas,202503,4225,1616,1407,7248,10.912,"66,42%","38,72%"
313010,Mg-Igarape,202503,7838,5453,5014,18305,48.475,"37,76%","16,17%"
313020,Mg-Igaratinga,202503,725,1899,998,3622,11.252,"32,19%","6,44%"
313030,Mg-Iguatama,202503,904,746,1017,2667,6.845,"38,96%","13,21%"
313040,Mg-Ijaci,202503,1229,1043,761,3033,7.291,"41,60%","16,86%"
313050,Mg-Ilicinea,202503,1594,2429,1513,5536,13.171,"42,03%","12,10%"
313055,Mg-Imbe de Minas,202503,3017,1075,937,5029,7.208,"69,77%","41,86%"
313060,Mg-Inconfidentes,202503,971,1200,1001,3172,7.510,"42,24%","12,93%"
313065,Mg-Indaiabira,202503,3252,807,758,4817,6.379,"75,51%","50,98%"
313070,Mg-Indianopolis,202503,867,799,685,2351,6.309,"37,26%","13,74%"
313080,Mg-Ingai,202503,447,262,410,1119,2.633,"42,50%","16,98%"
313090,Mg-Inhapim,202503,8117,2928,3871,14916,23.000,"64,85%","35,29%"
313100,Mg-Inhauma,202503,1847,817,868,3532,6.435,"54,89%","28,70%"
313110,Mg-Inimutaba,202503,1675,1351,1724,4750,7.587,"62,61%","22,08%"
313115,Mg-Ipaba,202503,2924,2469,2364,7757,17.554,"44,19%","16,66%"
313120,Mg-Ipanema,202503,4950,2479,2569,9998,20.095,"49,75%","24,63%"
313130,Mg-Ipatinga,202503,32655,22030,29953,84638,235.445,"35,95%","13,87%"
313140,Mg-Ipiacu,202503,964,377,597,1938,3.823,"50,69%","25,22%"
313150,Mg-Ipuiuna,202503,818,1745,1799,4362,9.299,"46,91%","8,80%"
313160,Mg-Irai de Minas,202503,1624,1023,1275,3922,7.423,"52,84%","21,88%"
313170,Mg-Itabira,202503,10421,11126,12621,34168,117.747,"29,02%","8,85%"
313180,Mg-Itabirinha de Mantena,202503,3550,1542,2082,7174,10.560,"67,94%","33,62%"
313190,Mg-Itabirito,202503,4542,4140,4720,13402,55.877,"23,98%","8,13%"
313200,Mg-Itacambira,202503,1672,510,779,2961,4.265,"69,43%","39,20%"
313210,Mg-Itacarambi,202503,6437,2907,2664,12008,17.521,"68,53%","36,74%"
313220,Mg-Itaguara,202503,1642,1726,2269,5637,14.325,"39,35%","11,46%"
313230,Mg-Itaipe,202503,5249,1445,1190,7884,10.549,"74,74%","49,76%"
313240,Mg-Itajuba,202503,10709,9401,8797,28907,96.632,"29,91%","11,08%"
313250,Mg-Itamarandiba,202503,8298,5439,5603,19340,34.137,"56,65%","24,31%"
313260,Mg-Itamarati de Minas,202503,631,798,754,2183,3.730,"58,53%","16,92%"
313270,Mg-Itambacuri,202503,8028,2851,3278,14157,21.296,"66,48%","37,70%"
313280,Mg-Itambe do Mato Dentro,202503,579,353,443,1375,2.175,"63,22%","26,62%"
313290,Mg-Itamogi,202503,1599,1502,947,4048,11.062,"36,59%","14,45%"
313300,Mg-Itamonte,202503,2366,1694,1783,5843,15.193,"38,46%","15,57%"
313310,Mg-Itanhandu,202503,1521,1849,1651,5021,15.684,"32,01%","9,70%"
313320,Mg-Itanhomi,202503,1788,1842,1440,5070,11.298,"44,88%","15,83%"
313330,Mg-Itaobim,202503,5289,3228,3629,12146,19.354,"62,76%","27,33%"
313340,Mg-Itapagipe,202503,2068,1043,1331,4442,14.004,"31,72%","14,77%"
313350,Mg-Itapecerica,202503,2266,2535,2987,7788,21.462,"36,29%","10,56%"
313360,Mg-Itapeva,202503,1760,1333,1565,4658,13.332,"34,94%","13,20%"
313370,Mg-Itatiaiucu,202503,1402,1581,2417,5400,13.603,"39,70%","10,31%"
313375,Mg-Itau de Minas,202503,1040,1733,2275,5048,14.655,"34,45%","7,10%"
313380,Mg-Itauna,202503,6473,5460,5662,17595,102.500,"17,17%","6,32%"
313390,Mg-Itaverava,202503,1396,725,564,2685,5.752,"46,68%","24,27%"
313400,Mg-Itinga,202503,5155,2024,2775,9954,13.982,"71,19%","36,87%"
313410,Mg-Itueta,202503,1989,818,1105,3912,6.218,"62,91%","31,99%"
313420,Mg-Ituiutaba,202503,11537,12406,18873,42816,106.397,"40,24%","10,84%"
313430,Mg-Itumirim,202503,1548,769,837,3154,6.845,"46,08%","22,62%"
313440,Mg-Iturama,202503,8609,3139,3868,15616,40.011,"39,03%","21,52%"
313450,Mg-Itutinga,202503,598,741,747,2086,4.347,"47,99%","13,76%"
313460,Mg-Jaboticatubas,202503,3320,2547,1626,7493,21.214,"35,32%","15,65%"
313470,Mg-Jacinto,202503,4244,1432,1579,7255,11.169,"64,96%","38,00%"
313480,Mg-Jacui,202503,1207,1183,1420,3810,7.663,"49,72%","15,75%"
313490,Mg-Jacutinga,202503,1773,2790,4284,8847,26.705,"33,13%","6,64%"
313500,Mg-Jaguaracu,202503,402,462,747,1611,3.173,"50,77%","12,67%"
313505,Mg-Jaiba,202503,15536,6274,5486,27296,39.379,"69,32%","39,45%"
313507,Mg-Jampruca,202503,1600,783,805,3188,4.306,"74,04%","37,16%"
313510,Mg-Janauba,202503,16676,13785,15257,45718,73.281,"62,39%","22,76%"
313520,Mg-Januaria,202503,24729,9694,9501,43924,67.087,"65,47%","36,86%"
313530,Mg-Japaraiba,202503,438,571,679,1688,4.672,"36,13%","9,38%"
313535,Mg-Japonvar,202503,3454,1720,1845,7019,8.357,"83,99%","41,33%"
313540,Mg-Jeceaba,202503,953,790,884,2627,6.428,"40,87%","14,83%"
313545,Mg-Jenipapo de Minas,202503,1786,1108,1054,3948,6.124,"64,47%","29,16%"
313550,Mg-Jequeri,202503,3858,1394,1447,6699,12.652,"52,95%","30,49%"
313560,Mg-Jequitai,202503,3421,740,1152,5313,6.460,"82,24%","52,96%"
313570,Mg-Jequitiba,202503,1367,930,682,2979,6.098,"48,85%","22,42%"
313580,Mg-Jequitinhonha,202503,7690,3112,3694,14496,24.509,"59,15%","31,38%"
313590,Mg-Jesuania,202503,1560,866,916,3342,5.296,"63,10%","29,46%"
313600,Mg-Joaima,202503,6914,1736,1658,10308,14.084,"73,19%","49,09%"
313610,Mg-Joanesia,202503,1208,664,538,2410,4.304,"55,99%","28,07%"
313620,Mg-Joao Monlevade,202503,7531,4549,3934,16014,83.360,"19,21%","9,03%"
313630,Mg-Joao Pinheiro,202503,10189,6151,6406,22746,48.532,"46,87%","20,99%"
313640,Mg-Joaquim Felicio,202503,1486,555,875,2916,3.891,"74,94%","38,19%"
313650,Mg-Jordania,202503,2467,1456,1256,5179,10.536,"49,16%","23,41%"
313652,Mg-Jose Goncalves de Minas,202503,1412,669,613,2694,3.993,"67,47%","35,36%"
313655,Mg-Jose Raydan,202503,1373,687,626,2686,4.352,"61,72%","31,55%"
313657,Mg-Josenopolis,202503,1361,717,722,2800,3.607,"77,63%","37,73%"
313660,Mg-Nova Uniao,202503,1722,945,772,3439,6.083,"56,53%","28,31%"
313665,Mg-Juatuba,202503,6861,4213,5069,16143,32.726,"49,33%","20,96%"
313670,Mg-Juiz de Fora,202503,60728,47175,46521,154424,565.764,"27,29%","10,73%"
313680,Mg-Juramento,202503,1414,762,786,2962,3.815,"77,64%","37,06%"
313690,Mg-Juruaia,202503,957,1643,888,3488,11.543,"30,22%","8,29%"
313695,Mg-Juvenilia,202503,2526,975,1243,4744,5.929,"80,01%","42,60%"
313700,Mg-Ladainha,202503,5947,1945,1593,9485,14.399,"65,87%","41,30%"
313710,Mg-Lagamar,202503,1399,722,1066,3187,6.672,"47,77%","20,97%"
313720,Mg-Lagoa da Prata,202503,6881,5915,7242,20038,53.583,"37,40%","12,84%"
313730,Mg-Lagoa dos Patos,202503,1615,605,701,2921,3.285,"88,92%","49,16%"
313740,Mg-Lagoa Dourada,202503,2409,2857,1424,6690,13.116,"51,01%","18,37%"
313750,Mg-Lagoa Formosa,202503,3533,1578,1734,6845,19.507,"35,09%","18,11%"
313753,Mg-Lagoa Grande,202503,1472,1963,1797,5232,9.210,"56,81%","15,98%"
313760,Mg-Lagoa Santa,202503,8471,6515,6754,21740,79.981,"27,18%","10,59%"
313770,Mg-Lajinha,202503,7858,2804,2803,13465,21.422,"62,86%","36,68%"
313780,Mg-Lambari,202503,4110,3352,3674,11136,20.950,"53,16%","19,62%"
313790,Mg-Lamim,202503,953,475,484,1912,3.226,"59,27%","29,54%"
313800,Mg-Laranjal,202503,1169,956,989,3114,6.042,"51,54%","19,35%"
313810,Mg-Lassance,202503,2541,945,1281,4767,7.358,"64,79%","34,53%"
313820,Mg-Lavras,202503,11145,13019,17460,41624,109.884,"37,88%","10,14%"
313830,Mg-Leandro Ferreira,202503,464,475,306,1245,3.270,"38,07%","14,19%"
313835,Mg-Leme do Prado,202503,996,836,882,2714,4.387,"61,86%","22,70%"
313840,Mg-Leopoldina,202503,7661,9141,7642,24444,52.696,"46,39%","14,54%"
313850,Mg-Liberdade,202503,1100,625,612,2337,4.775,"48,94%","23,04%"
313860,Mg-Lima Duarte,202503,3454,2434,2429,8317,17.712,"46,96%","19,50%"
313862,Mg-Limeira do Oeste,202503,724,621,1500,2845,9.087,"31,31%","7,97%"
313865,Mg-Lontra,202503,3639,1809,1386,6834,8.968,"76,20%","40,58%"
313867,Mg-Luisburgo,202503,2116,1603,965,4684,7.195,"65,10%","29,41%"
313868,Mg-Luislandia,202503,3074,1159,1084,5317,6.329,"84,01%","48,57%"
313870,Mg-Luminarias,202503,1096,777,1184,3057,5.731,"53,34%","19,12%"
313880,Mg-Luz,202503,2660,1865,2193,6718,18.304,"36,70%","14,53%"
313890,Mg-Machacalis,202503,3063,729,1090,4882,6.579,"74,21%","46,56%"
313900,Mg-Machado,202503,5852,5525,7411,18788,38.831,"48,38%","15,07%"
313910,Mg-Madre de Deus de Minas,202503,650,944,859,2453,5.341,"45,93%","12,17%"
313920,Mg-Malacacheta,202503,4306,2677,1920,8903,17.751,"50,15%","24,26%"
313925,Mg-Mamonas,202503,1939,1107,1116,4162,6.096,"68,27%","31,81%"
313930,Mg-Manga,202503,7471,3594,3982,15047,19.188,"78,42%","38,94%"
313940,Mg-Manhuacu,202503,10237,14289,9459,33985,96.545,"35,20%","10,60%"
313950,Mg-Manhumirim,202503,6434,2932,2926,12292,20.970,"58,62%","30,68%"
313960,Mg-Mantena,202503,5504,3841,4962,14307,27.358,"52,30%","20,12%"
313970,Mg-Maravilhas,202503,2117,1117,1401,4635,7.518,"61,65%","28,16%"
313980,Mg-Mar de Espanha,202503,1647,1706,1170,4523,13.119,"34,48%","12,55%"
313990,Mg-Maria da Fe,202503,3501,1733,1812,7046,14.557,"48,40%","24,05%"
314000,Mg-Mariana,202503,12744,7067,8709,28520,64.058,"44,52%","19,89%"
314010,Mg-Marilac,202503,1732,797,672,3201,4.320,"74,10%","40,09%"
314015,Mg-Mario Campos,202503,2891,2213,2163,7267,16.546,"43,92%","17,47%"
314020,Mg-Maripa de Minas,202503,437,662,668,1767,3.532,"50,03%","12,37%"
314030,Mg-Marlieria,202503,856,756,1022,2634,4.761,"55,32%","17,98%"
314040,Mg-Marmelopolis,202503,1112,338,296,1746,3.299,"52,93%","33,71%"
314050,Mg-Martinho Campos,202503,2870,1556,1765,6191,14.461,"42,81%","19,85%"
314053,Mg-Martins Soares,202503,3357,1475,1459,6291,8.725,"72,10%","38,48%"
314055,Mg-Mata Verde,202503,3981,1072,1000,6053,9.458,"64,00%","42,09%"
314060,Mg-Materlandia,202503,1722,710,1012,3444,3.982,"86,49%","43,24%"
314070,Mg-Mateus Leme,202503,5557,3957,3433,12947,40.239,"32,18%","13,81%"
314080,Mg-Matias Barbosa,202503,2456,1812,2084,6352,14.501,"43,80%","16,94%"
314085,Mg-Matias Cardoso,202503,3561,1846,1543,6950,8.975,"77,44%","39,68%"
314090,Mg-Matipo,202503,6980,3818,2683,13481,19.054,"70,75%","36,63%"
314100,Mg-Mato Verde,202503,4434,1572,1709,7715,12.238,"63,04%","36,23%"
314110,Mg-Matozinhos,202503,5393,4537,4712,14642,39.291,"37,27%","13,73%"
314120,Mg-Matutina,202503,422,352,861,1635,3.907,"41,85%","10,80%"
314130,Mg-Medeiros,202503,817,498,642,1957,4.040,"48,44%","20,22%"
314140,Mg-Medina,202503,5998,3347,3496,12841,20.492,"62,66%","29,27%"
314150,Mg-Mendes Pimentel,202503,1602,774,1133,3509,5.651,"62,10%","28,35%"
314160,Mg-Merces,202503,2293,1893,1975,6161,10.609,"58,07%","21,61%"
314170,Mg-Mesquita,202503,1062,719,998,2779,5.038,"55,16%","21,08%"
314180,Mg-Minas Novas,202503,6639,4593,4580,15812,24.191,"65,36%","27,44%"
314190,Mg-Minduri,202503,697,496,427,1620,3.815,"42,46%","18,27%"
314200,Mg-Mirabela,202503,4400,2502,2185,9087,14.029,"64,77%","31,36%"
314210,Mg-Miradouro,202503,1547,1740,1500,4787,9.026,"53,04%","17,14%"
314220,Mg-Mirai,202503,2055,2021,1665,5741,13.922,"41,24%","14,76%"
314225,Mg-Miravania,202503,1480,807,954,3241,4.011,"80,80%","36,90%"
314230,Mg-Moeda,202503,783,948,848,2579,5.291,"48,74%","14,80%"
314240,Mg-Moema,202503,1350,1050,778,3178,7.778,"40,86%","17,36%"
314250,Mg-Monjolos,202503,311,488,536,1335,2.196,"60,79%","14,16%"
314260,Mg-Monsenhor Paulo,202503,1182,1228,727,3137,8.550,"36,69%","13,82%"
314270,Mg-Montalvania,202503,5095,2388,2162,9645,14.160,"68,11%","35,98%"
314280,Mg-Monte Alegre de Minas,202503,3621,2417,3039,9077,20.666,"43,92%","17,52%"
314290,Mg-Monte Azul,202503,6922,2550,2484,11956,20.577,"58,10%","33,64%"
314300,Mg-Monte Belo,202503,1871,1658,1863,5392,13.340,"40,42%","14,03%"
314310,Mg-Monte Carmelo,202503,2897,3970,3497,10364,49.354,"21,00%","5,87%"
314315,Mg-Monte Formoso,202503,1648,779,761,3188,4.449,"71,66%","37,04%"
314320,Mg-Monte Santo de Minas,202503,2939,3087,3049,9075,21.301,"42,60%","13,80%"
314330,Mg-Montes Claros,202503,62460,70023,61832,194315,434.321,"44,74%","14,38%"
314340,Mg-Monte Siao,202503,3218,2111,2382,7711,24.933,"30,93%","12,91%"
314345,Mg-Montezuma,202503,2545,1071,1192,4808,6.979,"68,89%","36,47%"
314350,Mg-Morada Nova de Minas,202503,627,1189,1539,3355,9.364,"35,83%","6,70%"
314360,Mg-Morro da Garca,202503,486,680,726,1892,2.438,"77,60%","19,93%"
314370,Mg-Morro do Pilar,202503,1019,387,444,1850,3.174,"58,29%","32,10%"
314380,Mg-Munhoz,202503,1678,993,1060,3731,7.857,"47,49%","21,36%"
314390,Mg-Muriae,202503,15320,12905,13878,42103,108.161,"38,93%","14,16%"
314400,Mg-Mutum,202503,5973,4053,3462,13488,28.670,"47,05%","20,83%"
314410,Mg-Muzambinho,202503,2537,3463,3452,9452,22.527,"41,96%","11,26%"
314420,Mg-Nacip Raydan,202503,778,485,673,1936,2.437,"79,44%","31,92%"
314430,Mg-Nanuque,202503,6569,5525,6001,18095,35.554,"50,89%","18,48%"
314435,Mg-Naque,202503,1914,1495,1814,5223,6.442,"81,08%","29,71%"
314437,Mg-Natalandia,202503,1324,476,598,2398,3.626,"66,13%","36,51%"
314440,Mg-Natercia,202503,560,681,540,1781,4.800,"37,10%","11,67%"
314450,Mg-Nazareno,202503,1289,1286,1394,3969,8.390,"47,31%","15,36%"
314460,Mg-Nepomuceno,202503,4678,3704,3182,11564,25.774,"44,87%","18,15%"
314465,Mg-Ninheira,202503,4049,1411,1810,7270,10.915,"66,61%","37,10%"
314467,Mg-Nova Belem,202503,1341,779,537,2657,3.156,"84,19%","42,49%"
314470,Mg-Nova Era,202503,2312,2245,2651,7208,17.807,"40,48%","12,98%"
314480,Mg-Nova Lima,202503,9074,9082,10761,28917,119.142,"24,27%","7,62%"
314490,Mg-Nova Modica,202503,1199,654,770,2623,3.731,"70,30%","32,14%"
314500,Mg-Nova Ponte,202503,1857,1860,2043,5760,15.113,"38,11%","12,29%"
314505,Mg-Nova Porteirinha,202503,3068,1128,1136,5332,6.780,"78,64%","45,25%"
314510,Mg-Nova Resende,202503,3147,2333,1424,6904,16.854,"40,96%","18,67%"
314520,Mg-Nova Serrana,202503,8376,14351,8525,31252,112.910,"27,68%","7,42%"
314530,Mg-Novo Cruzeiro,202503,9210,4875,3191,17276,27.453,"62,93%","33,55%"
314535,Mg-Novo Oriente de Minas,202503,4000,1291,1512,6803,10.501,"64,78%","38,09%"
314537,Mg-Novorizonte,202503,1800,953,913,3666,4.630,"79,18%","38,88%"
314540,Mg-Olaria,202503,439,328,333,1100,1.986,"55,39%","22,10%"
314545,Mg-Olhos D Agua,202503,2307,1103,937,4347,5.520,"78,75%","41,79%"
314550,Mg-Olimpio Noronha,202503,615,636,730,1981,2.616,"75,73%","23,51%"
314560,Mg-Oliveira,202503,5452,4458,5302,15212,40.552,"37,51%","13,44%"
314570,Mg-Oliveira Fortes,202503,494,307,224,1025,2.062,"49,71%","23,96%"
314580,Mg-Onca de Pitangui,202503,540,468,510,1518,3.027,"50,15%","17,84%"
314585,Mg-Oratorios,202503,776,703,860,2339,5.076,"46,08%","15,29%"
314587,Mg-Orizania,202503,3594,1490,1502,6586,8.759,"75,19%","41,03%"
314590,Mg-Ouro Branco,202503,4075,4191,4430,12696,40.411,"31,42%","10,08%"
314600,Mg-Ouro Fino,202503,1486,2481,2626,6593,33.227,"19,84%","4,47%"
314610,Mg-Ouro Preto,202503,9804,8541,8815,27160,77.601,"35,00%","12,63%"
314620,Mg-Ouro Verde de Minas,202503,3653,830,981,5464,5.858,"93,27%","62,36%"
314625,Mg-Padre Carvalho,202503,2327,730,770,3827,5.085,"75,26%","45,76%"
314630,Mg-Padre Paraiso,202503,6201,3089,2982,12272,17.537,"69,98%","35,36%"
314640,Mg-Paineiras,202503,1071,340,486,1897,4.273,"44,40%","25,06%"
314650,Mg-Pains,202503,603,588,867,2058,8.341,"24,67%","7,23%"
314655,Mg-Pai Pedro,202503,1805,1107,1243,4155,5.634,"73,75%","32,04%"
314660,Mg-Paiva,202503,381,189,206,776,1.498,"51,80%","25,43%"
314670,Mg-Palma,202503,1746,794,949,3489,5.742,"60,76%","30,41%"
314675,Mg-Palmopolis,202503,2596,974,677,4247,6.373,"66,64%","40,73%"
314690,Mg-Papagaios,202503,2965,2075,1927,6967,14.207,"49,04%","20,87%"
314700,Mg-Paracatu,202503,12916,10334,12711,35961,98.397,"36,55%","13,13%"
314710,Mg-Para de Minas,202503,7727,8206,9957,25890,102.033,"25,37%","7,57%"
314720,Mg-Paraguacu,202503,1467,3065,3079,7611,22.357,"34,04%","6,56%"
314730,Mg-Paraisopolis,202503,2288,2339,3724,8351,21.005,"39,76%","10,89%"
314740,Mg-Paraopeba,202503,4265,3086,2684,10035,24.800,"40,46%","17,20%"
314750,Mg-Passabem,202503,320,236,270,826,1.617,"51,08%","19,79%"
314760,Mg-Passa Quatro,202503,1293,2215,2929,6437,15.842,"40,63%","8,16%"
314770,Mg-Passa Tempo,202503,502,1240,1576,3318,8.696,"38,16%","5,77%"
314780,Mg-Passa Vinte,202503,536,229,237,1002,2.301,"43,55%","23,29%"
314790,Mg-Passos,202503,13772,10623,9807,34202,116.530,"29,35%","11,82%"
314795,Mg-Patis,202503,2078,954,867,3899,4.863,"80,18%","42,73%"
314800,Mg-Patos de Minas,202503,12495,11048,12142,35685,167.870,"21,26%","7,44%"
314810,Mg-Patrocinio,202503,11552,10441,11133,33126,93.852,"35,30%","12,31%"
314820,Mg-Patrocinio do Muriae,202503,1339,894,801,3034,5.735,"52,90%","23,35%"
314830,Mg-Paula Candido,202503,2563,1421,1399,5383,8.786,"61,27%","29,17%"
314840,Mg-Paulistas,202503,1338,743,573,2654,4.429,"59,92%","30,21%"
314850,Mg-Pavao,202503,3617,635,970,5222,8.168,"63,93%","44,28%"
314860,Mg-Pecanha,202503,5226,2249,2109,9584,17.843,"53,71%","29,29%"
314870,Mg-Pedra Azul,202503,8746,2780,3613,15139,24.999,"60,56%","34,99%"
314875,Mg-Pedra Bonita,202503,3967,1107,717,5791,7.559,"76,61%","52,48%"
314880,Mg-Pedra do Anta,202503,858,589,582,2029,3.371,"60,19%","25,45%"
314890,Mg-Pedra do Indaia,202503,495,584,676,1755,4.232,"41,47%","11,70%"
314900,Mg-Pedra Dourada,202503,969,625,564,2158,2.883,"74,85%","33,61%"
314910,Mg-Pedralva,202503,1802,1887,1555,5244,10.924,"48,00%","16,50%"
314915,Mg-Pedras de Maria da Cruz,202503,3314,1832,1466,6612,10.619,"62,27%","31,21%"
314920,Mg-Pedrinopolis,202503,865,274,512,1651,3.404,"48,50%","25,41%"
314930,Mg-Pedro Leopoldo,202503,6967,6150,6973,20090,64.910,"30,95%","10,73%"
314940,Mg-Pedro Teixeira,202503,452,320,317,1089,1.854,"58,74%","24,38%"
314950,Mg-Pequeri,202503,522,693,725,1940,3.448,"56,26%","15,14%"
314960,Mg-Pequi,202503,1224,493,821,2538,4.258,"59,61%","28,75%"
314970,Mg-Perdigao,202503,1997,1363,1217,4577,12.925,"35,41%","15,45%"
314980,Mg-Perdizes,202503,3267,1420,1586,6273,17.830,"35,18%","18,32%"
314990,Mg-Perdoes,202503,1989,2875,3641,8505,21.991,"38,67%","9,04%"
314995,Mg-Periquito,202503,1688,1677,1538,4903,6.647,"73,76%","25,39%"
315000,Mg-Pescador,202503,1154,729,678,2561,3.587,"71,40%","32,17%"
315010,Mg-Piau,202503,642,372,290,1304,2.854,"45,69%","22,49%"
315015,Mg-Piedade de Caratinga,202503,4010,1646,1055,6711,8.883,"75,55%","45,14%"
315020,Mg-Piedade de Ponte Nova,202503,760,786,1042,2588,4.056,"63,81%","18,74%"
315030,Mg-Piedade do Rio Grande,202503,699,593,740,2032,4.697,"43,26%","14,88%"
315040,Mg-Piedade dos Gerais,202503,1619,591,556,2766,5.175,"53,45%","31,29%"
315050,Mg-Pimenta,202503,960,951,894,2805,8.794,"31,90%","10,92%"
315053,Mg-Pingo D Agua,202503,1480,800,1030,3310,4.845,"68,32%","30,55%"
315057,Mg-Pintopolis,202503,2796,1377,1394,5567,7.231,"76,99%","38,67%"
315060,Mg-Piracema,202503,752,897,753,2402,6.884,"34,89%","10,92%"
315070,Mg-Pirajuba,202503,1124,559,617,2300,5.762,"39,92%","19,51%"
315080,Mg-Piranga,202503,4334,2372,3140,9846,17.360,"56,72%","24,97%"
315090,Mg-Pirangucu,202503,1008,893,678,2579,6.271,"41,13%","16,07%"
315100,Mg-Piranguinho,202503,1424,1261,1758,4443,9.451,"47,01%","15,07%"
315110,Mg-Pirapetinga,202503,2427,1586,2109,6122,11.408,"53,66%","21,27%"
315120,Mg-Pirapora,202503,14123,8196,9657,31976,57.543,"55,57%","24,54%"
315130,Mg-Pirauba,202503,2132,1760,1545,5437,11.958,"45,47%","17,83%"
315140,Mg-Pitangui,202503,5313,2437,2432,10182,27.734,"36,71%","19,16%"
315150,Mg-Piumhi,202503,4568,4263,5900,14731,37.742,"39,03%","12,10%"
315160,Mg-Planura,202503,2307,1180,1760,5247,11.484,"45,69%","20,09%"
315170,Mg-Poco Fundo,202503,1395,2104,1853,5352,16.791,"31,87%","8,31%"
315180,Mg-Pocos de Caldas,202503,10706,14345,20220,45271,171.533,"26,39%","6,24%"
315190,Mg-Pocrane,202503,3062,763,1064,4889,8.468,"57,74%","36,16%"
315200,Mg-Pompeu,202503,5573,4594,4022,14189,32.305,"43,92%","17,25%"
315210,Mg-Ponte Nova,202503,6085,7390,8449,21924,59.569,"36,80%","10,22%"
315213,Mg-Ponto Chique,202503,1637,644,513,2794,3.807,"73,39%","43,00%"
315217,Mg-Ponto dos Volantes,202503,3718,2043,1808,7569,11.077,"68,33%","33,57%"
315220,Mg-Porteirinha,202503,11271,8294,8627,28192,38.668,"72,91%","29,15%"
315230,Mg-Porto Firme,202503,3729,1280,1289,6298,10.825,"58,18%","34,45%"
315240,Mg-Pote,202503,3235,2437,1933,7605,13.751,"55,31%","23,53%"
315250,Mg-Pouso Alegre,202503,15428,14322,15962,45712,160.751,"28,44%","9,60%"
315260,Mg-Pouso Alto,202503,730,685,963,2378,6.755,"35,20%","10,81%"
315270,Mg-Prados,202503,1101,1170,1001,3272,9.327,"35,08%","11,80%"
315280,Mg-Prata,202503,3563,2832,3916,10311,29.578,"34,86%","12,05%"
315290,Mg-Pratapolis,202503,1127,861,1055,3043,8.551,"35,59%","13,18%"
315300,Mg-Pratinha,202503,841,405,474,1720,3.673,"46,83%","22,90%"
315310,Mg-Presidente Bernardes,202503,1569,785,933,3287,4.883,"67,32%","32,13%"
315320,Mg-Presidente Juscelino,202503,514,753,545,1812,3.493,"51,88%","14,72%"
315330,Mg-Presidente Kubitschek,202503,773,645,807,2225,3.154,"70,55%","24,51%"
315340,Mg-Presidente Olegario,202503,2856,1790,2479,7125,19.177,"37,15%","14,89%"
315350,Mg-Alto Jequitiba,202503,2429,1497,987,4913,8.596,"57,15%","28,26%"
315360,Mg-Prudente de Morais,202503,1704,1836,1804,5344,11.940,"44,76%","14,27%"
315370,Mg-Quartel Geral,202503,477,670,633,1780,3.237,"54,99%","14,74%"
315380,Mg-Queluzita,202503,141,318,155,614,1.800,"34,11%","7,83%"
315390,Mg-Raposos,202503,1458,1215,1053,3726,16.735,"22,26%","8,71%"
315400,Mg-Raul Soares,202503,4915,3236,2821,10972,23.882,"45,94%","20,58%"
315410,Mg-Recreio,202503,1574,1703,1609,4886,11.337,"43,10%","13,88%"
315415,Mg-Reduto,202503,1731,1919,1272,4922,8.170,"60,24%","21,19%"
315420,Mg-Resende Costa,202503,1450,1703,1417,4570,11.520,"39,67%","12,59%"
315430,Mg-Resplendor,202503,3372,2859,2843,9074,17.612,"51,52%","19,15%"
315440,Mg-Ressaquinha,202503,1261,681,727,2669,4.641,"57,51%","27,17%"
315445,Mg-Riachinho,202503,2834,959,1348,5141,6.890,"74,62%","41,13%"
315450,Mg-Riacho dos Machados,202503,3130,1500,1661,6291,8.886,"70,80%","35,22%"
315460,Mg-Ribeirao das Neves,202503,70336,38136,34632,143104,344.828,"41,50%","20,40%"
315470,Mg-Ribeirao Vermelho,202503,569,534,813,1916,4.201,"45,61%","13,54%"
315480,Mg-Rio Acima,202503,1711,1236,1987,4934,10.626,"46,43%","16,10%"
315490,Mg-Rio Casca,202503,2093,2521,2809,7423,12.921,"57,45%","16,20%"
315500,Mg-Rio Doce,202503,559,333,501,1393,2.542,"54,80%","21,99%"
315510,Mg-Rio do Prado,202503,2021,748,745,3514,4.679,"75,10%","43,19%"
315520,Mg-Rio Espera,202503,1720,581,510,2811,5.479,"51,30%","31,39%"
315530,Mg-Rio Manso,202503,1219,458,579,2256,5.727,"39,39%","21,29%"
315540,Mg-Rio Novo,202503,1316,1591,1771,4678,8.689,"53,84%","15,15%"
315550,Mg-Rio Paranaiba,202503,1559,1721,1604,4884,15.143,"32,25%","10,30%"
315560,Mg-Rio Pardo de Minas,202503,12578,3958,3385,19921,29.123,"68,40%","43,19%"
315570,Mg-Rio Piracicaba,202503,2460,1918,2797,7175,15.001,"47,83%","16,40%"
315580,Mg-Rio Pomba,202503,3142,2626,2144,7912,17.856,"44,31%","17,60%"
315590,Mg-Rio Preto,202503,1682,528,573,2783,5.240,"53,11%","32,10%"
315600,Mg-Rio Vermelho,202503,3446,1996,2332,7774,12.815,"60,66%","26,89%"
315610,Mg-Ritapolis,202503,913,827,1055,2795,5.115,"54,64%","17,85%"
315620,Mg-Rochedo de Minas,202503,635,446,375,1456,2.363,"61,62%","26,87%"
315630,Mg-Rodeiro,202503,1452,1091,1021,3564,9.064,"39,32%","16,02%"
315640,Mg-Romaria,202503,531,267,211,1009,3.440,"29,33%","15,44%"
315645,Mg-Rosario da Limeira,202503,1406,750,723,2879,4.896,"58,80%","28,72%"
315650,Mg-Rubelita,202503,2705,644,958,4307,5.572,"77,30%","48,55%"
315660,Mg-Rubim,202503,2411,1730,1825,5966,10.575,"56,42%","22,80%"
315670,Mg-Sabara,202503,18482,14431,14577,47490,134.286,"35,36%","13,76%"
315680,Mg-Sabinopolis,202503,3682,2562,2333,8577,14.382,"59,64%","25,60%"
315690,Mg-Sacramento,202503,2952,2976,4393,10321,27.891,"37,00%","10,58%"
315700,Mg-Salinas,202503,10588,6832,7573,24993,41.641,"60,02%","25,43%"
315710,Mg-Salto da Divisa,202503,1713,1297,1311,4321,6.164,"70,10%","27,79%"
315720,Mg-Santa Barbara,202503,6019,3214,3520,12753,31.756,"40,16%","18,95%"
315725,Mg-Santa Barbara do Leste,202503,3475,1242,1296,6013,8.737,"68,82%","39,77%"
315727,Mg-Santa Barbara do Monte Verde,202503,752,542,493,1787,3.199,"55,86%","23,51%"
315730,Mg-Santa Barbara do Tugurio,202503,697,717,586,2000,4.262,"46,93%","16,35%"
315733,Mg-Santa Cruz de Minas,202503,1659,1371,1048,4078,8.321,"49,01%","19,94%"
315737,Mg-Santa Cruz de Salinas,202503,1606,667,984,3257,3.944,"82,58%","40,72%"
315740,Mg-Santa Cruz do Escalvado,202503,1316,635,578,2529,4.743,"53,32%","27,75%"
315750,Mg-Santa Efigenia de Minas,202503,1558,889,786,3233,4.067,"79,49%","38,31%"
315760,Mg-Santa Fe de Minas,202503,1400,595,775,2770,3.551,"78,01%","39,43%"
315765,Mg-Santa Helena de Minas,202503,3509,707,693,4909,6.059,"81,02%","57,91%"
315770,Mg-Santa Juliana,202503,1699,1386,1219,4304,16.568,"25,98%","10,25%"
315780,Mg-Santa Luzia,202503,39084,27161,25438,91683,229.483,"39,95%","17,03%"
315790,Mg-Santa Margarida,202503,6483,3394,2083,11960,16.903,"70,76%","38,35%"
315800,Mg-Santa Maria de Itabira,202503,1768,1512,1235,4515,10.716,"42,13%","16,50%"
315810,Mg-Santa Maria do Salto,202503,2105,616,1093,3814,4.803,"79,41%","43,83%"
315820,Mg-Santa Maria do Suacui,202503,4045,1701,1661,7407,12.898,"57,43%","31,36%"
315830,Mg-Santana da Vargem,202503,769,1484,1627,3880,6.781,"57,22%","11,34%"
315840,Mg-Santana de Cataguases,202503,781,700,919,2400,3.553,"67,55%","21,98%"
315850,Mg-Santana de Pirapama,202503,1770,837,803,3410,7.079,"48,17%","25,00%"
315860,Mg-Santana do Deserto,202503,508,708,548,1764,3.819,"46,19%","13,30%"
315870,Mg-Santana do Garambeu,202503,752,339,310,1401,2.175,"64,41%","34,57%"
315880,Mg-Santana do Jacare,202503,909,1009,955,2873,4.265,"67,36%","21,31%"
315890,Mg-Santana do Manhuacu,202503,2839,1598,980,5417,9.236,"58,65%","30,74%"
315895,Mg-Santana do Paraiso,202503,6028,5627,6777,18432,48.286,"38,17%","12,48%"
315900,Mg-Santana do Riacho,202503,1459,674,533,2666,5.579,"47,79%","26,15%"
315910,Mg-Santana dos Montes,202503,1225,284,258,1767,3.507,"50,38%","34,93%"
315920,Mg-Santa Rita de Caldas,202503,888,1057,1626,3571,8.588,"41,58%","10,34%"
315930,Mg-Santa Rita de Jacutinga,202503,1222,484,590,2296,4.836,"47,48%","25,27%"
315935,Mg-Santa Rita de Minas,202503,1747,1121,1051,3919,6.952,"56,37%","25,13%"
315940,Mg-Santa Rita do Ibitipoca,202503,683,588,421,1692,3.344,"50,60%","20,42%"
315950,Mg-Santa Rita do Itueto,202503,2316,701,520,3537,5.973,"59,22%","38,77%"
315960,Mg-Santa Rita do Sapucai,202503,3455,5588,6413,15456,42.320,"36,52%","8,16%"
315970,Mg-Santa Rosa da Serra,202503,781,474,365,1620,3.476,"46,61%","22,47%"
315980,Mg-Santa Vitoria,202503,3027,2304,4157,9488,21.745,"43,63%","13,92%"
315990,Mg-Santo Antonio do Amparo,202503,3472,2756,2750,8978,17.651,"50,86%","19,67%"
316000,Mg-Santo Antonio do Aventureiro,202503,903,642,502,2047,3.881,"52,74%","23,27%"
316010,Mg-Santo Antonio do Grama,202503,656,678,586,1920,4.342,"44,22%","15,11%"
316020,Mg-Santo Antonio do Itambe,202503,1325,643,519,2487,3.979,"62,50%","33,30%"
316030,Mg-Santo Antonio do Jacinto,202503,4003,1694,1877,7574,10.397,"72,85%","38,50%"
316040,Mg-Santo Antonio do Monte,202503,1963,3779,3187,8929,28.358,"31,49%","6,92%"
316045,Mg-Santo Antonio do Retiro,202503,4072,715,670,5457,6.743,"80,93%","60,39%"
316050,Mg-Santo Antonio do Rio Abaixo,202503,537,336,454,1327,1.853,"71,61%","28,98%"
316060,Mg-Santo Hipolito,202503,813,464,531,1808,2.720,"66,47%","29,89%"
316070,Mg-Santos Dumont,202503,7068,5435,5047,17550,43.392,"40,45%","16,29%"
316080,Mg-Sao Bento Abade,202503,1197,960,711,2868,4.835,"59,32%","24,76%"
316090,Mg-Sao Bras do Suacui,202503,482,436,582,1500,4.133,"36,29%","11,66%"
316095,Mg-Sao Domingos das Dores,202503,1371,1495,1118,3984,5.778,"68,95%","23,73%"
316100,Mg-Sao Domingos do Prata,202503,2377,2403,2437,7217,17.771,"40,61%","13,38%"
316105,Mg-Sao Felix de Minas,202503,1094,661,582,2337,3.252,"71,86%","33,64%"
316110,Mg-Sao Francisco,202503,22408,9407,8441,40256,54.239,"74,22%","41,31%"
316120,Mg-Sao Francisco de Paula,202503,901,1019,1680,3600,6.293,"57,21%","14,32%"
316130,Mg-Sao Francisco de Sales,202503,1068,682,1101,2851,5.857,"48,68%","18,23%"
316140,Mg-Sao Francisco do Gloria,202503,956,868,1094,2918,4.866,"59,97%","19,65%"
316150,Mg-Sao Geraldo,202503,1796,1421,1986,5203,10.517,"49,47%","17,08%"
316160,Mg-Sao Geraldo da Piedade,202503,1283,562,549,2394,3.258,"73,48%","39,38%"
316165,Mg-Sao Geraldo do Baixio,202503,1090,511,562,2163,3.175,"68,13%","34,33%"
316170,Mg-Sao Goncalo do Abaete,202503,1640,858,869,3367,7.521,"44,77%","21,81%"
316180,Mg-Sao Goncalo do Para,202503,1178,1762,2148,5088,12.192,"41,73%","9,66%"
316190,Mg-Sao Goncalo do Rio Abaixo,202503,1791,1889,4425,8105,12.353,"65,61%","14,50%"
316200,Mg-Sao Goncalo do Sapucai,202503,5370,3124,3006,11500,24.480,"46,98%","21,94%"
316210,Mg-Sao Gotardo,202503,5436,5593,6938,17967,43.309,"41,49%","12,55%"
316220,Mg-Sao Joao Batista do Gloria,202503,610,1035,1258,2903,7.912,"36,69%","7,71%"
316225,Mg-Sao Joao da Lagoa,202503,2120,781,874,3775,4.950,"76,26%","42,83%"
316230,Mg-Sao Joao da Mata,202503,863,300,331,1494,3.000,"49,80%","28,77%"
316240,Mg-Sao Joao da Ponte,202503,9244,4164,3587,16995,24.269,"70,03%","38,09%"
316245,Mg-Sao Joao das Missoes,202503,5184,3492,1955,10631,13.467,"78,94%","38,49%"
316250,Mg-Sao Joao Del Rei,202503,10215,9543,9787,29545,94.062,"31,41%","10,86%"
316255,Mg-Sao Joao do Manhuacu,202503,4992,1975,1764,8731,11.614,"75,18%","42,98%"
316257,Mg-Sao Joao do Manteninha,202503,1878,960,1132,3970,5.468,"72,60%","34,35%"
316260,Mg-Sao Joao do Oriente,202503,2912,1431,1662,6005,7.139,"84,12%","40,79%"
316265,Mg-Sao Joao do Pacui,202503,1585,623,876,3084,4.052,"76,11%","39,12%"
316270,Mg-Sao Joao do Paraiso,202503,5946,3848,2841,12635,24.604,"51,35%","24,17%"
316280,Mg-Sao Joao Evangelista,202503,3653,2404,2075,8132,15.617,"52,07%","23,39%"
316290,Mg-Sao Joao Nepomuceno,202503,4185,3990,4562,12737,26.478,"48,10%","15,81%"
316292,Mg-Sao Joaquim de Bicas,202503,9292,4851,4736,18879,36.496,"51,73%","25,46%"
316294,Mg-Sao Jose da Barra,202503,1159,1144,1095,3398,8.084,"42,03%","14,34%"
316295,Mg-Sao Jose da Lapa,202503,4198,3233,3497,10928,27.710,"39,44%","15,15%"
316300,Mg-Sao Jose da Safira,202503,1796,607,669,3072,3.861,"79,56%","46,52%"
316310,Mg-Sao Jose da Varginha,202503,698,762,741,2201,4.677,"47,06%","14,92%"
316320,Mg-Sao Jose do Alegre,202503,703,829,667,2199,4.242,"51,84%","16,57%"
316330,Mg-Sao Jose do Divino,202503,1416,524,691,2631,3.501,"75,15%","40,45%"
316340,Mg-Sao Jose do Goiabal,202503,1245,857,840,2942,5.492,"53,57%","22,67%"
316350,Mg-Sao Jose do Jacuri,202503,2170,920,761,3851,6.298,"61,15%","34,46%"
316360,Mg-Sao Jose do Mantimento,202503,1183,282,305,1770,2.834,"62,46%","41,74%"
316370,Mg-Sao Lourenco,202503,6327,5648,5968,17943,46.653,"38,46%","13,56%"
316380,Mg-Sao Miguel do Anta,202503,2289,811,957,4057,6.430,"63,09%","35,60%"
316390,Mg-Sao Pedro da Uniao,202503,1007,578,493,2078,4.979,"41,74%","20,22%"
316400,Mg-Sao Pedro dos Ferros,202503,845,1159,1490,3494,7.194,"48,57%","11,75%"
316410,Mg-Sao Pedro do Suacui,202503,1903,737,719,3359,5.166,"65,02%","36,84%"
316420,Mg-Sao Romao,202503,3308,1060,984,5352,10.553,"50,72%","31,35%"
316430,Mg-Sao Roque de Minas,202503,1147,720,806,2673,7.341,"36,41%","15,62%"
316440,Mg-Sao Sebastiao da Bela Vista,202503,600,1146,950,2696,6.694,"40,27%","8,96%"
316443,Mg-Sao Sebastiao da Vargem Alegre,202503,648,527,617,1792,3.219,"55,67%","20,13%"
316447,Mg-Sao Sebastiao do Anta,202503,3545,908,952,5405,6.386,"84,64%","55,51%"
316450,Mg-Sao Sebastiao do Maranhao,202503,2928,1620,1801,6349,10.244,"61,98%","28,58%"
316460,Mg-Sao Sebastiao do Oeste,202503,1720,1070,1085,3875,9.355,"41,42%","18,39%"
316470,Mg-Sao Sebastiao do Paraiso,202503,7384,7410,6789,21583,74.742,"28,88%","9,88%"
316480,Mg-Sao Sebastiao do Rio Preto,202503,291,183,156,630,1.248,"50,48%","23,32%"
316490,Mg-Sao Sebastiao do Rio Verde,202503,311,369,373,1053,2.373,"44,37%","13,11%"
316500,Mg-Sao Tiago,202503,1555,1649,1865,5069,11.517,"44,01%","13,50%"
316510,Mg-Sao Tomas de Aquino,202503,1148,855,660,2663,6.853,"38,86%","16,75%"
316520,Mg-Sao Tome das Letras,202503,985,1212,1071,3268,7.089,"46,10%","13,89%"
316530,Mg-Sao Vicente de Minas,202503,1431,844,1019,3294,6.935,"47,50%","20,63%"
316540,Mg-Sapucai-Mirim,202503,1206,1126,970,3302,6.462,"51,10%","18,66%"
316550,Mg-Sardoa,202503,2602,712,791,4105,5.164,"79,49%","50,39%"
316553,Mg-Sarzedo,202503,5285,4270,5664,15219,39.327,"38,70%","13,44%"
316555,Mg-Setubinha,202503,4974,1789,1257,8020,10.032,"79,94%","49,58%"
316556,Mg-Sem-Peixe,202503,653,364,437,1454,2.441,"59,57%","26,75%"
316557,Mg-Senador Amaral,202503,2555,1213,603,4371,6.458,"67,68%","39,56%"
316560,Mg-Senador Cortes,202503,348,618,517,1483,2.319,"63,95%","15,01%"
316570,Mg-Senador Firmino,202503,1646,1400,1346,4392,7.945,"55,28%","20,72%"
316580,Mg-Senador Jose Bento,202503,211,257,265,733,2.137,"34,30%","9,87%"
316590,Mg-Senador Modestino Goncalves,202503,1428,622,1076,3126,4.035,"77,47%","35,39%"
316600,Mg-Senhora de Oliveira,202503,1856,698,557,3111,5.584,"55,71%","33,24%"
316610,Mg-Senhora do Porto,202503,911,498,515,1924,3.088,"62,31%","29,50%"
316620,Mg-Senhora dos Remedios,202503,3215,1244,1289,5748,10.640,"54,02%","30,22%"
316630,Mg-Sericita,202503,3105,1218,761,5084,7.536,"67,46%","41,20%"
316640,Mg-Seritinga,202503,250,202,165,617,1.864,"33,10%","13,41%"
316650,Mg-Serra Azul de Minas,202503,1709,845,653,3207,3.829,"83,76%","44,63%"
316660,Mg-Serra da Saudade,202503,75,131,125,331,854,"38,76%","8,78%"
316670,Mg-Serra dos Aimores,202503,1671,1395,1320,4386,6.936,"63,24%","24,09%"
316680,Mg-Serra do Salitre,202503,2693,1666,2485,6844,12.210,"56,05%","22,06%"
316690,Mg-Serrania,202503,894,1513,1635,4042,7.802,"51,81%","11,46%"
316695,Mg-Serranopolis de Minas,202503,1647,732,858,3237,4.496,"72,00%","36,63%"
316700,Mg-Serranos,202503,668,163,204,1035,2.035,"50,86%","32,83%"
316710,Mg-Serro,202503,4966,3551,3031,11548,22.550,"51,21%","22,02%"
316720,Mg-Sete Lagoas,202503,30763,19255,20312,70330,237.931,"29,56%","12,93%"
316730,Mg-Silveirania,202503,556,454,401,1411,2.391,"59,01%","23,25%"
316740,Mg-Silvianopolis,202503,1345,615,663,2623,6.336,"41,40%","21,23%"
316750,Mg-Simao Pereira,202503,553,354,401,1308,3.060,"42,75%","18,07%"
316760,Mg-Simonesia,202503,7752,3214,2159,13125,20.339,"64,53%","38,11%"
316770,Mg-Sobralia,202503,1954,660,798,3412,5.175,"65,93%","37,76%"
316780,Mg-Soledade de Minas,202503,537,933,482,1952,5.733,"34,05%","9,37%"
316790,Mg-Tabuleiro,202503,667,878,643,2188,4.098,"53,39%","16,28%"
316800,Mg-Taiobeiras,202503,8788,6645,4799,20232,34.392,"58,83%","25,55%"
316805,Mg-Taparuba,202503,1443,474,515,2432,3.492,"69,64%","41,32%"
316810,Mg-Tapira,202503,1118,441,543,2102,4.212,"49,91%","26,54%"
316820,Mg-Tapirai,202503,324,229,400,953,1.707,"55,83%","18,98%"
316830,Mg-Taquaracu de Minas,202503,1233,556,730,2519,4.368,"57,67%","28,23%"
316840,Mg-Tarumirim,202503,4159,1505,1740,7404,15.072,"49,12%","27,59%"
316850,Mg-Teixeiras,202503,2744,1580,1908,6232,12.634,"49,33%","21,72%"
316860,Mg-Teofilo Otoni,202503,27653,18513,19717,65883,142.571,"46,21%","19,40%"
316870,Mg-Timoteo,202503,8815,7589,8910,25314,84.087,"30,10%","10,48%"
316880,Mg-Tiradentes,202503,1445,1053,864,3362,8.008,"41,98%","18,04%"
316890,Mg-Tiros,202503,1338,779,755,2872,8.172,"35,14%","16,37%"
316900,Mg-Tocantins,202503,3606,2372,2943,8921,16.574,"53,83%","21,76%"
316905,Mg-Tocos do Moji,202503,886,323,437,1646,3.899,"42,22%","22,72%"
316910,Mg-Toledo,202503,1276,1014,1085,3375,7.541,"44,76%","16,92%"
316920,Mg-Tombos,202503,2528,1003,1303,4834,8.699,"55,57%","29,06%"
316930,Mg-Tres Coracoes,202503,8931,10966,8603,28500,78.079,"36,50%","11,44%"
316935,Mg-Tres Marias,202503,5174,3798,4040,13012,29.927,"43,48%","17,29%"
316940,Mg-Tres Pontas,202503,7433,6622,5273,19328,57.086,"33,86%","13,02%"
316950,Mg-Tumiritinga,202503,2494,866,973,4333,5.973,"72,54%","41,75%"
316960,Mg-Tupaciguara,202503,6567,2637,4073,13277,26.482,"50,14%","24,80%"
316970,Mg-Turmalina,202503,4993,3887,3948,12828,20.650,"62,12%","24,18%"
316980,Mg-Turvolandia,202503,1341,910,743,2994,5.078,"58,96%","26,41%"
316990,Mg-Uba,202503,12678,12990,13733,39401,107.222,"36,75%","11,82%"
317000,Mg-Ubai,202503,5413,1443,1228,8084,11.977,"67,50%","45,19%"
317005,Mg-Ubaporanga,202503,3390,2125,2036,7551,13.423,"56,25%","25,26%"
317010,Mg-Uberaba,202503,37153,22609,26278,86040,354.142,"24,30%","10,49%"
317020,Mg-Uberlandia,202503,66263,64724,84202,215189,754.954,"28,50%","8,78%"
317030,Mg-Umburatiba,202503,914,438,405,1757,2.742,"64,08%","33,33%"
317040,Mg-Unai,202503,8293,10881,12834,32008,90.724,"35,28%","9,14%"
317043,Mg-Uniao de Minas,202503,869,455,682,2006,3.848,"52,13%","22,58%"
317047,Mg-Uruana de Minas,202503,949,646,858,2453,3.360,"73,01%","28,24%"
317050,Mg-Urucania,202503,927,1607,1974,4508,10.875,"41,45%","8,52%"
317052,Mg-Urucuia,202503,3257,1658,1765,6680,18.291,"36,52%","17,81%"
317057,Mg-Vargem Alegre,202503,2660,713,1092,4465,5.834,"76,53%","45,59%"
317060,Mg-Vargem Bonita,202503,400,345,719,1464,2.206,"66,36%","18,13%"
317065,Mg-Vargem Grande do Rio Pardo,202503,1808,998,846,3652,4.727,"77,26%","38,25%"
317070,Mg-Varginha,202503,8801,10244,6902,25947,142.802,"18,17%","6,16%"
317075,Mg-Varjao de Minas,202503,1624,733,870,3227,7.243,"44,55%","22,42%"
317080,Mg-Varzea da Palma,202503,7910,4131,4981,17022,34.639,"49,14%","22,84%"
317090,Mg-Varzelandia,202503,8869,3130,2332,14331,19.214,"74,59%","46,16%"
317100,Mg-Vazante,202503,2266,1689,2090,6045,20.433,"29,58%","11,09%"
317103,Mg-Verdelandia,202503,3394,1263,1308,5965,7.770,"76,77%","43,68%"
317107,Mg-Veredinha,202503,1746,975,1330,4051,5.257,"77,06%","33,21%"
317110,Mg-Verissimo,202503,704,332,599,1635,3.480,"46,98%","20,23%"
317115,Mg-Vermelho Novo,202503,1834,933,746,3513,5.034,"69,79%","36,43%"
317120,Mg-Vespasiano,202503,26093,15856,16723,58672,136.826,"42,88%","19,07%"
317130,Mg-Vicosa,202503,9372,9237,8975,27584,79.221,"34,82%","11,83%"
317140,Mg-Vieiras,202503,1189,622,784,2595,3.780,"68,65%","31,46%"
317150,Mg-Mathias Lobato,202503,1300,482,625,2407,3.069,"78,43%","42,36%"
317160,Mg-Virgem da Lapa,202503,3618,2125,2783,8526,11.867,"71,85%","30,49%"
317170,Mg-Virginia,202503,2374,1539,1844,5757,9.142,"62,97%","25,97%"
317180,Mg-Virginopolis,202503,972,2144,2026,5142,10.519,"48,88%","9,24%"
317190,Mg-Virgolandia,202503,1351,778,764,2893,4.530,"63,86%","29,82%"
317200,Mg-Visconde do Rio Branco,202503,5063,6783,7467,19313,40.608,"47,56%","12,47%"
317210,Mg-Volta Grande,202503,1342,707,824,2873,4.473,"64,23%","30,00%"
317220,Mg-Wenceslau Braz,202503,483,307,273,1063,2.387,"44,53%","20,23%"
320334,Es-Marechal Floriano,202503,1316,2530,2693,6539,18.743,"34,89%","7,02%"
320190,Es-Domingos Martins,202503,2989,5480,3645,12114,37.972,"31,90%","7,87%"
320150,Es-Colatina,202503,10679,16599,18376,45654,128.622,"35,49%","8,30%"
320495,Es-Sao Roque do Canaa,202503,966,2082,1644,4692,11.271,"41,63%","8,57%"
320320,Es-Linhares,202503,16147,23755,18038,57940,181.912,"31,85%","8,88%"
320245,Es-Ibatiba,202503,2435,5588,3796,11819,27.308,"43,28%","8,92%"
320140,Es-Castelo,202503,4129,3988,4000,12117,39.396,"30,76%","10,48%"
320460,Es-Santa Teresa,202503,2564,2331,2261,7156,23.796,"30,07%","10,77%"
320455,Es-Santa Maria de Jetiba,202503,5112,5373,4509,14994,45.062,"33,27%","11,34%"
320240,Es-Guarapari,202503,15365,20030,15116,50511,134.944,"37,43%","11,39%"
320506,Es-Venda Nova do Imigrante,202503,2950,3174,3784,9908,25.168,"39,37%","11,72%"
320503,Es-Vargem Alta,202503,2388,2874,3108,8370,20.353,"41,12%","11,73%"
320520,Es-Vila Velha,202503,59849,44089,46522,150460,502.899,"29,92%","11,90%"
320260,Es-Iconha,202503,1542,1330,1656,4528,12.793,"35,39%","12,05%"
320290,Es-Itarana,202503,1338,1376,1530,4244,10.984,"38,64%","12,18%"
320335,Es-Marilandia,202503,1621,2242,2583,6446,13.014,"49,53%","12,46%"
320313,Es-Joao Neiva,202503,1797,2087,3187,7071,14.391,"49,13%","12,49%"
320530,Es-Vitoria,202503,44176,26605,31919,102700,342.800,"29,96%","12,89%"
320030,Es-Alfredo Chaves,202503,1861,1719,2159,5739,14.373,"39,93%","12,95%"
320470,Es-Sao Gabriel da Palha,202503,4648,4871,4675,14194,34.210,"41,49%","13,59%"
320120,Es-Cachoeiro de Itapemirim,202503,27379,20110,25259,72748,198.323,"36,68%","13,81%"
320440,Es-Rio Novo do Sul,202503,1613,1462,1463,4538,11.479,"39,53%","14,05%"
320010,Es-Afonso Claudio,202503,4779,6537,5237,16553,32.446,"51,02%","14,73%"
320435,Es-Rio Bananal,202503,3010,3814,1622,8446,20.229,"41,75%","14,88%"
320501,Es-Sooretama,202503,4282,5986,5979,16247,28.453,"57,10%","15,05%"
320265,Es-Irupi,202503,2377,3649,2351,8377,14.513,"57,72%","16,38%"
320060,Es-Aracruz,202503,16943,14212,17562,48717,102.410,"47,57%","16,54%"
320500,Es-Serra,202503,95554,65258,66723,227535,572.274,"39,76%","16,70%"
320090,Es-Barra de Sao Francisco,202503,7821,6996,8448,23265,45.250,"51,41%","17,28%"
320390,Es-Nova Venecia,202503,9398,6992,8959,25349,52.084,"48,67%","18,04%"
320300,Es-Iuna,202503,5510,5827,3677,15014,30.444,"49,32%","18,10%"
320170,Es-Conceicao do Castelo,202503,2282,1875,1579,5736,12.448,"46,08%","18,33%"
320225,Es-Governador Lindenberg,202503,2181,1723,1901,5805,11.467,"50,62%","19,02%"
320040,Es-Anchieta,202503,6198,4042,3921,14161,32.584,"43,46%","19,02%"
320080,Es-Baixo Guandu,202503,6297,4012,4897,15206,32.694,"46,51%","19,26%"
320200,Es-Dores do Rio Preto,202503,1374,1498,1343,4215,6.885,"61,22%","19,96%"
320510,Es-Viana,202503,15709,10629,11736,38074,78.442,"48,54%","20,03%"
320316,Es-Laranja da Terra,202503,2320,1525,1357,5202,11.572,"44,95%","20,05%"
320180,Es-Divino de Sao Lourenco,202503,1078,1109,627,2814,5.359,"52,51%","20,12%"
320310,Es-Jeronimo Monteiro,202503,2515,1775,2635,6925,12.079,"57,33%","20,82%"
320070,Es-Atilio Vivacqua,202503,2316,1671,2400,6387,11.013,"58,00%","21,03%"
320230,Es-Guacui,202503,6685,5207,5356,17248,31.290,"55,12%","21,36%"
320250,Es-Ibiracu,202503,2634,2092,4461,9187,12.261,"74,93%","21,48%"
320220,Es-Fundao,202503,4050,2787,3774,10611,18.824,"56,37%","21,52%"
320270,Es-Itaguacu,202503,3037,1720,2152,6909,14.065,"49,12%","21,59%"
320490,Es-Sao Mateus,202503,28902,20044,25620,74566,133.359,"55,91%","21,67%"
320020,Es-Alegre,202503,6820,3736,4571,15127,30.744,"49,20%","22,18%"
320210,Es-Ecoporanga,202503,5051,4021,3756,12828,22.670,"56,59%","22,28%"
320130,Es-Cariacica,202503,85407,49006,52383,186796,375.485,"49,75%","22,75%"
320115,Es-Brejetuba,202503,3111,3266,1621,7998,13.642,"58,63%","22,80%"
320410,Es-Pinheiros,202503,5801,4228,3922,13951,24.825,"56,20%","23,37%"
320450,Es-Santa Leopoldina,202503,3290,1497,1640,6427,13.747,"46,75%","23,93%"
320400,Es-Pancas,202503,4617,2455,2974,10046,19.270,"52,13%","23,96%"
320370,Es-Muniz Freire,202503,4584,2918,2544,10046,18.811,"53,40%","24,37%"
320305,Es-Jaguare,202503,7916,5178,4849,17943,31.232,"57,45%","25,35%"
320013,Es-Aguia Branca,202503,2583,1402,1863,5848,10.124,"57,76%","25,51%"
320110,Es-Bom Jesus do Norte,202503,2749,1840,2530,7119,10.764,"66,14%","25,54%"
320430,Es-Presidente Kennedy,202503,3755,2400,2908,9063,14.647,"61,88%","25,64%"
320420,Es-Piuma,202503,6090,3370,3748,13208,23.682,"55,77%","25,72%"
320515,Es-Vila Pavao,202503,2396,1383,1660,5439,9.298,"58,50%","25,77%"
320360,Es-Mucurici,202503,1558,1119,1337,4014,5.660,"70,92%","27,53%"
320350,Es-Montanha,202503,5521,3405,4413,13339,19.752,"67,53%","27,95%"
320517,Es-Vila Valerio,202503,3993,2090,1574,7657,14.263,"53,68%","28,00%"
320405,Es-Pedro Canario,202503,6380,3985,4714,15079,22.048,"68,39%","28,94%"
320380,Es-Muqui,202503,4126,1846,2045,8017,14.213,"56,41%","29,03%"
320465,Es-Sao Domingos do Norte,202503,2641,1257,1724,5622,9.008,"62,41%","29,32%"
320332,Es-Marataizes,202503,13352,6039,6410,25801,45.418,"56,81%","29,40%"
320480,Es-Sao Jose do Calcado,202503,3478,1618,2645,7741,11.373,"68,06%","30,58%"
320050,Es-Apiaca,202503,2333,1252,1911,5496,7.474,"73,53%","31,21%"
320340,Es-Mimoso do Sul,202503,7966,3384,4973,16323,25.179,"64,83%","31,64%"
320330,Es-Mantenopolis,202503,4195,2003,1976,8174,13.173,"62,05%","31,85%"
320100,Es-Boa Esperanca,202503,4672,2388,2623,9683,14.079,"68,78%","33,18%"
320280,Es-Itapemirim,202503,14524,5546,6225,26295,43.362,"60,64%","33,49%"
320160,Es-Conceicao da Barra,202503,10148,5064,6337,21549,28.953,"74,43%","35,05%"
320016,Es-Agua Doce do Norte,202503,4415,1637,2151,8203,12.559,"65,32%","35,15%"
320035,Es-Alto Rio Novo,202503,2966,1153,1057,5176,7.747,"66,81%","38,29%"
320425,Es-Ponto Belo,202503,2637,1071,1471,5179,6.696,"77,34%","39,38%"
320255,Es-Ibitirama,202503,4759,1441,1173,7373,9.973,"73,93%","47,72%"
330420,Rj-Resende,202503,16552,11930,13114,41596,137.612,"30,23%","12,03%"
330340,Rj-Nova Friburgo,202503,26137,14765,14469,55371,203.328,"27,23%","12,85%"
330220,Rj-Itaperuna,202503,15835,11870,14241,41946,107.246,"39,11%","14,77%"
330515,Rj-Sao Jose do Vale do Rio Preto,202503,3451,3519,2005,8975,22.799,"39,37%","15,14%"
330630,Rj-Volta Redonda,202503,43380,21249,32408,97037,279.898,"34,67%","15,50%"
330040,Rj-Barra Mansa,202503,28577,13238,14776,56591,181.688,"31,15%","15,73%"
330030,Rj-Barra do Pirai,202503,15981,8759,8789,33529,98.501,"34,04%","16,22%"
330022,Rj-Areal,202503,2014,2279,2020,6313,12.236,"51,59%","16,46%"
330060,Rj-Bom Jesus do Itabapoana,202503,6304,5829,7001,19134,37.172,"51,47%","16,96%"
330320,Rj-Nilopolis,202503,26736,9903,10857,47496,155.544,"30,54%","17,19%"
330330,Rj-Niteroi,202503,91939,28102,33492,153533,516.720,"29,71%","17,79%"
330210,Rj-Itaocara,202503,4240,2980,3281,10501,23.643,"44,41%","17,93%"
330460,Rj-Santa Maria Madalena,202503,1919,1084,805,3808,10.579,"36,00%","18,14%"
330470,Rj-Santo Antonio de Padua,202503,8065,4829,6465,19359,43.686,"44,31%","18,46%"
330205,Rj-Italva,202503,2693,1607,1850,6150,14.517,"42,36%","18,55%"
330411,Rj-Porto Real,202503,3912,2452,2515,8879,21.064,"42,15%","18,57%"
330455,Rj-Rio de Janeiro,202503,1250609,424593,408991,2084193,6.729.894,"30,97%","18,58%"
330390,Rj-Petropolis,202503,54867,27163,32516,114546,294.983,"38,83%","18,60%"
330150,Rj-Cordeiro,202503,4014,2297,2431,8742,21.444,"40,77%","18,72%"
330225,Rj-Itatiaia,202503,6190,3591,3594,13375,32.694,"40,91%","18,93%"
330400,Rj-Pirai,202503,5565,2898,2490,10953,29.054,"37,70%","19,15%"
330240,Rj-Macae,202503,51351,21505,18896,91752,264.138,"34,74%","19,44%"
330050,Rj-Bom Jardim,202503,5805,2655,2806,11266,29.736,"37,89%","19,52%"
330490,Rj-Sao Goncalo,202503,188422,66806,73305,328533,960.652,"34,20%","19,61%"
330095,Rj-Comendador Levy Gasparian,202503,1797,1368,1447,4612,9.044,"51,00%","19,87%"
330270,Rj-Marica,202503,42318,34398,49311,126027,211.986,"59,45%","19,96%"
330370,Rj-Paraiba do Sul,202503,8915,5256,5135,19306,44.467,"43,42%","20,05%"
330015,Rj-Aperibe,202503,2337,1360,1529,5226,11.420,"45,76%","20,46%"
330510,Rj-Sao Joao de Meriti,202503,95985,32183,30424,158592,466.536,"33,99%","20,57%"
330130,Rj-Casimiro de Abreu,202503,10068,5348,4693,20109,48.563,"41,41%","20,73%"
330412,Rj-Quatis,202503,2940,1405,1351,5696,14.158,"40,23%","20,77%"
330110,Rj-Cantagalo,202503,4170,1872,1619,7661,19.996,"38,31%","20,85%"
330452,Rj-Rio das Ostras,202503,35625,13962,14073,63660,168.099,"37,87%","21,19%"
330620,Rj-Vassouras,202503,7640,3836,3535,15011,35.904,"41,81%","21,28%"
330480,Rj-Sao Fidelis,202503,8920,4699,3180,16799,41.197,"40,78%","21,65%"
330580,Rj-Teresopolis,202503,38545,19697,18139,76381,176.692,"43,23%","21,81%"
330590,Rj-Trajano de Morais,202503,2365,1384,795,4544,10.652,"42,66%","22,20%"
330395,Rj-Pinheiral,202503,5715,2281,2684,10680,25.085,"42,58%","22,78%"
330610,Rj-Valenca,202503,16332,7052,6735,30119,71.462,"42,15%","22,85%"
330070,Rj-Cabo Frio,202503,54439,23641,22038,100118,238.166,"42,04%","22,86%"
330280,Rj-Mendes,202503,4149,1911,2523,8583,18.049,"47,55%","22,99%"
330023,Rj-Armacao de Buzios,202503,9766,5453,5514,20733,42.442,"48,85%","23,01%"
330385,Rj-Paty do Alferes,202503,7299,4475,3256,15030,31.345,"47,95%","23,29%"
330520,Rj-Sao Pedro da Aldeia,202503,25797,10839,9650,46286,110.556,"41,87%","23,33%"
330310,Rj-Natividade,202503,3715,1624,2123,7462,15.550,"47,99%","23,89%"
330010,Rj-Angra dos Reis,202503,43038,17937,19417,80392,179.120,"44,88%","24,03%"
330120,Rj-Carmo,202503,4296,1786,2252,8334,17.740,"46,98%","24,22%"
330160,Rj-Duas Barras,202503,2753,1293,1118,5164,11.354,"45,48%","24,25%"
330600,Rj-Tres Rios,202503,20324,9653,9874,39851,82.300,"48,42%","24,70%"
330180,Rj-Engenheiro Paulo de Frontin,202503,3138,1290,1350,5778,12.648,"45,68%","24,81%"
330290,Rj-Miguel Pereira,202503,6986,2490,2889,12365,28.123,"43,97%","24,84%"
330440,Rj-Rio Claro,202503,4498,1926,2901,9325,17.950,"51,95%","25,06%"
330450,Rj-Rio das Flores,202503,2338,1373,1240,4951,9.264,"53,44%","25,24%"
330025,Rj-Arraial do Cabo,202503,8279,4224,5907,18410,32.794,"56,14%","25,25%"
330513,Rj-Sao Jose de Uba,202503,1870,1202,1141,4213,7.315,"57,59%","25,56%"
330100,Rj-Campos dos Goytacazes,202503,133156,46639,35238,215033,519.011,"41,43%","25,66%"
330380,Rj-Parati,202503,12243,4753,5387,22383,47.614,"47,01%","25,71%"
330415,Rj-Quissama,202503,5956,3834,4259,14049,23.126,"60,75%","25,75%"
330115,Rj-Cardoso Moreira,202503,3455,1752,2518,7725,13.403,"57,64%","25,78%"
330540,Rj-Sapucaia,202503,4736,2334,2558,9628,18.289,"52,64%","25,90%"
330530,Rj-Sao Sebastiao do Alto,202503,2102,1073,1567,4742,7.999,"59,28%","26,28%"
330090,Rj-Cambuci,202503,4036,1581,1994,7611,15.070,"50,50%","26,78%"
330093,Rj-Carapebus,202503,3952,1542,2288,7782,14.325,"54,32%","27,59%"
330285,Rj-Mesquita,202503,49466,15308,16962,81736,178.803,"45,71%","27,67%"
330260,Rj-Mangaratiba,202503,12203,3720,4237,20160,43.624,"46,21%","27,97%"
330187,Rj-Iguaba Grande,202503,8532,4383,5485,18400,29.577,"62,21%","28,85%"
330300,Rj-Miracema,202503,8239,2966,3902,15107,28.411,"53,17%","29,00%"
330550,Rj-Saquarema,202503,27713,15421,20837,63971,95.201,"67,20%","29,11%"
330430,Rj-Rio Bonito,202503,17537,5493,6308,29338,59.113,"49,63%","29,67%"
330020,Rj-Araruama,202503,41071,13868,14862,69801,137.773,"50,66%","29,81%"
330230,Rj-Laje do Muriae,202503,2273,1037,1688,4998,7.584,"65,90%","29,97%"
330560,Rj-Silva Jardim,202503,6631,2849,3001,12481,22.026,"56,66%","30,11%"
330080,Rj-Cachoeiras de Macacu,202503,18147,5704,6119,29970,59.837,"50,09%","30,33%"
330360,Rj-Paracambi,202503,13281,4204,4269,21754,43.656,"49,83%","30,42%"
330200,Rj-Itaguai,202503,37931,10727,11914,60572,123.980,"48,86%","30,59%"
330170,Rj-Duque de Caxias,202503,266902,80889,84101,431892,866.347,"49,85%","30,81%"
330414,Rj-Queimados,202503,46159,15379,14464,76002,149.093,"50,98%","30,96%"
330245,Rj-Macuco,202503,1743,1497,2034,5274,5.601,"94,16%","31,12%"
330140,Rj-Conceicao de Macabu,202503,6808,1896,2197,10901,21.769,"50,08%","31,27%"
330410,Rj-Porciuncula,202503,5613,1721,2577,9911,17.832,"55,58%","31,48%"
330190,Rj-Itaborai,202503,77218,24910,28096,130224,240.040,"54,25%","32,17%"
330045,Rj-Belford Roxo,202503,168776,42569,44277,255622,518.263,"49,32%","32,57%"
330575,Rj-Tangua,202503,11027,3607,3670,18304,32.858,"55,71%","33,56%"
330250,Rj-Mage,202503,83057,27465,25887,136409,244.092,"55,88%","34,03%"
330185,Rj-Guapimirim,202503,19177,6112,6910,32199,54.300,"59,30%","35,32%"
330500,Rj-Sao Joao da Barra,202503,13834,5442,6669,25945,38.708,"67,03%","35,74%"
330350,Rj-Nova Iguacu,202503,304619,66190,77517,448326,843.046,"53,18%","36,13%"
330475,Rj-Sao Francisco de Itabapoana,202503,17128,6197,5282,28607,47.368,"60,39%","36,16%"
330570,Rj-Sumidouro,202503,5722,2204,1442,9368,15.690,"59,71%","36,47%"
330227,Rj-Japeri,202503,38675,9351,9398,57424,102.149,"56,22%","37,86%"
330615,Rj-Varre e Sai,202503,4366,1397,1083,6846,10.559,"64,84%","41,35%"
330555,Rj-Seropedica,202503,35545,6936,9194,51675,84.737,"60,98%","41,95%"
351240,Sp-Cordeiropolis,202503,323,2755,3747,6825,25.130,"27,16%","1,29%"
351150,Sp-Cerquilho,202503,923,3999,2629,7551,46.217,"16,34%","2,00%"
354570,Sp-Santa Albertina,202503,159,654,923,1736,6.543,"26,53%","2,43%"
354380,Sp-Rinopolis,202503,261,743,472,1476,9.357,"15,77%","2,79%"
354880,Sp-Sao Caetano do Sul,202503,5244,5219,8666,19129,172.109,"11,11%","3,05%"
354740,Sp-Santa Rita D Oeste,202503,86,199,427,712,2.790,"25,52%","3,08%"
354515,Sp-Saltinho,202503,273,641,625,1539,8.371,"18,38%","3,26%"
351130,Sp-Cedral,202503,470,1286,2516,4272,13.160,"32,46%","3,57%"
352590,Sp-Jundiai,202503,18395,11116,11953,41464,460.313,"9,01%","4,00%"
351905,Sp-Holambra,202503,657,768,760,2185,15.596,"14,01%","4,21%"
352050,Sp-Indaiatuba,202503,11313,14674,17676,43663,267.796,"16,30%","4,22%"
354670,Sp-Santa Gertrudes,202503,1025,1522,1431,3978,24.107,"16,50%","4,25%"
354400,Sp-Rio das Pedras,202503,1377,2466,1857,5700,32.267,"17,67%","4,27%"
351370,Sp-Descalvado,202503,1399,2574,3146,7119,32.622,"21,82%","4,29%"
352570,Sp-Jose Bonifacio,202503,1692,3482,2249,7423,37.859,"19,61%","4,47%"
350010,Sp-Adamantina,202503,1597,2540,3449,7586,35.642,"21,28%","4,48%"
352044,Sp-Ilha Solteira,202503,1220,2326,3180,6726,26.240,"25,63%","4,65%"
351518,Sp-Espirito Santo do Pinhal,202503,1961,2153,2379,6493,40.681,"15,96%","4,82%"
352650,Sp-Lavinia,202503,493,588,628,1709,9.909,"17,25%","4,98%"
355580,Sp-Urania,202503,459,1142,1606,3207,8.973,"35,74%","5,12%"
350060,Sp-Aguas de Sao Pedro,202503,146,234,504,884,2.829,"31,25%","5,16%"
352800,Sp-Macatuba,202503,885,1671,2296,4852,17.120,"28,34%","5,17%"
354580,Sp-Santa Barbara D Oeste,202503,9864,8083,9114,27061,189.338,"14,29%","5,21%"
353770,Sp-Piacatu,202503,293,921,931,2145,5.623,"38,15%","5,21%"
352680,Sp-Lencois Paulista,202503,3584,3764,3696,11044,68.395,"16,15%","5,24%"
350790,Sp-Brotas,202503,1329,2106,1988,5423,24.423,"22,20%","5,44%"
351200,Sp-Colina,202503,1045,1510,1421,3976,18.842,"21,10%","5,55%"
352470,Sp-Jaguariuna,202503,3431,3002,2766,9199,61.801,"14,88%","5,55%"
354910,Sp-Sao Joao da Boa Vista,202503,5398,5877,7587,18862,95.762,"19,70%","5,64%"
355620,Sp-Valinhos,202503,7465,4247,5164,16876,131.277,"12,86%","5,69%"
355560,Sp-Uchoa,202503,609,1320,1570,3499,10.627,"32,93%","5,73%"
354660,Sp-Santa Fe do Sul,202503,2079,2695,2675,7449,36.098,"20,64%","5,76%"
351110,Sp-Catanduva,202503,6950,5918,6433,19301,119.172,"16,20%","5,83%"
355080,Sp-Sao Sebastiao da Grama,202503,625,1241,1182,3048,10.484,"29,07%","5,96%"
353460,Sp-Osvaldo Cruz,202503,1917,3497,4233,9647,32.099,"30,05%","5,97%"
352140,Sp-Iracemapolis,202503,1341,1352,1717,4410,22.435,"19,66%","5,98%"
350190,Sp-Amparo,202503,4196,4283,5748,14227,69.717,"20,41%","6,02%"
350050,Sp-Aguas de Lindoia,202503,1100,1523,1598,4221,18.245,"23,14%","6,03%"
353130,Sp-Monte Alto,202503,2947,2473,3710,9130,48.725,"18,74%","6,05%"
355670,Sp-Vinhedo,202503,4850,4099,6290,15239,79.235,"19,23%","6,12%"
353900,Sp-Pirangi,202503,684,676,740,2100,11.076,"18,96%","6,18%"
350160,Sp-Americana,202503,15285,10066,13016,38367,246.655,"15,55%","6,20%"
351280,Sp-Cosmopolis,202503,3813,4012,4748,12573,61.204,"20,54%","6,23%"
351160,Sp-Cesario Lange,202503,1223,2296,2085,5604,19.588,"28,61%","6,24%"
355110,Sp-Sarapui,202503,664,1591,1289,3544,10.632,"33,33%","6,25%"
354070,Sp-Porto Ferreira,202503,3404,3976,4138,11518,53.940,"21,35%","6,31%"
353920,Sp-Pirapozinho,202503,1649,2282,2333,6264,26.065,"24,03%","6,33%"
354925,Sp-Sao Joao de Iracema,202503,119,281,376,776,1.880,"41,28%","6,33%"
353030,Sp-Mirassol,202503,4162,4980,5124,14266,65.485,"21,79%","6,36%"
353080,Sp-Moji-Mirim,202503,6077,5273,6240,17590,95.534,"18,41%","6,36%"
352260,Sp-Itapira,202503,4750,4261,5364,14375,73.919,"19,45%","6,43%"
355695,Sp-Vitoria Brasil,202503,119,262,414,795,1.826,"43,54%","6,52%"
351320,Sp-Cristais Paulista,202503,624,1168,1019,2811,9.543,"29,46%","6,54%"
350640,Sp-Bilac,202503,488,783,1338,2609,7.455,"35,00%","6,55%"
351000,Sp-Candido Mota,202503,1978,3698,4378,10054,30.172,"33,32%","6,56%"
350410,Sp-Atibaia,202503,10935,12513,10840,34288,166.043,"20,65%","6,59%"
355440,Sp-Terra Roxa,202503,526,603,745,1874,7.985,"23,47%","6,59%"
355365,Sp-Taquaral,202503,176,242,512,930,2.652,"35,07%","6,64%"
355680,Sp-Viradouro,202503,1177,1904,3246,6327,17.681,"35,78%","6,66%"
350115,Sp-Aluminio,202503,1195,1097,1087,3379,17.591,"19,21%","6,79%"
352585,Sp-Jumirim,202503,213,456,554,1223,3.123,"39,16%","6,82%"
353940,Sp-Piratininga,202503,1062,1599,1856,4517,15.554,"29,04%","6,83%"
353120,Sp-Monte Alegre do Sul,202503,606,528,429,1563,8.873,"17,62%","6,83%"
350580,Sp-Bastos,202503,1500,2078,3933,7511,21.900,"34,30%","6,85%"
352730,Sp-Louveira,202503,3719,3421,2071,9211,54.111,"17,02%","6,87%"
353475,Sp-Ouroeste,202503,730,1256,1523,3509,10.596,"33,12%","6,89%"
354920,Sp-Sao Joao das Duas Pontes,202503,182,307,839,1328,2.622,"50,65%","6,94%"
355600,Sp-Urupes,202503,978,1487,1469,3934,14.038,"28,02%","6,97%"
353570,Sp-Paraiso,202503,436,621,976,2033,6.211,"32,73%","7,02%"
353870,Sp-Piracicaba,202503,30834,28236,30465,89535,438.827,"20,40%","7,03%"
351650,Sp-Gabriel Monteiro,202503,198,368,614,1180,2.811,"41,98%","7,04%"
353750,Sp-Pereiras,202503,633,1436,1161,3230,8.969,"36,01%","7,06%"
355160,Sp-Serra Negra,202503,2189,2753,2842,7784,30.920,"25,17%","7,08%"
353690,Sp-Pedranopolis,202503,202,413,779,1394,2.848,"48,95%","7,09%"
350970,Sp-Campos do Jordao,202503,3425,4086,4611,12122,47.983,"25,26%","7,14%"
352400,Sp-Itupeva,202503,5302,4428,4754,14484,74.119,"19,54%","7,15%"
350480,Sp-Balsamo,202503,706,1205,791,2702,9.854,"27,42%","7,16%"
351440,Sp-Dracena,202503,3398,3257,4318,10973,46.664,"23,51%","7,28%"
352900,Sp-Marilia,202503,18001,18131,21437,57569,246.627,"23,34%","7,30%"
351800,Sp-Guarani D Oeste,202503,147,332,454,933,1.999,"46,67%","7,35%"
352270,Sp-Itapolis,202503,2980,2594,2417,7991,40.464,"19,75%","7,36%"
353340,Sp-Nova Odessa,202503,4733,3119,3781,11633,64.228,"18,11%","7,37%"
354520,Sp-Salto,202503,10353,7302,8846,26501,140.125,"18,91%","7,39%"
354690,Sp-Santa Lucia,202503,531,548,698,1777,7.181,"24,75%","7,39%"
352080,Sp-Inubia Paulista,202503,272,301,570,1143,3.671,"31,14%","7,41%"
354490,Sp-Sales Oliveira,202503,864,834,872,2570,11.654,"22,05%","7,41%"
353290,Sp-Nova Europa,202503,704,1227,2378,4309,9.459,"45,55%","7,44%"
351120,Sp-Catigua,202503,529,727,1058,2314,7.105,"32,57%","7,45%"
352480,Sp-Jales,202503,3737,3750,5464,12951,50.017,"25,89%","7,47%"
353430,Sp-Orlandia,202503,2929,2189,2203,7321,39.193,"18,68%","7,47%"
350650,Sp-Birigui,202503,9300,8234,9014,26548,122.988,"21,59%","7,56%"
352530,Sp-Jau,202503,10386,10583,12731,33700,137.323,"24,54%","7,56%"
352340,Sp-Itatiba,202503,9610,7963,9908,27481,126.403,"21,74%","7,60%"
351520,Sp-Estrela D Oeste,202503,738,733,1448,2919,9.655,"30,23%","7,64%"
350420,Sp-Auriflama,202503,1066,1326,1552,3944,13.873,"28,43%","7,68%"
355660,Sp-Vera Cruz,202503,791,1381,1783,3955,10.294,"38,42%","7,68%"
354250,Sp-Reginopolis,202503,605,600,855,2060,7.808,"26,38%","7,75%"
355510,Sp-Tupi Paulista,202503,1257,1198,1655,4110,16.206,"25,36%","7,76%"
354150,Sp-Presidente Venceslau,202503,2788,2649,2251,7688,35.902,"21,41%","7,77%"
353100,Sp-Moncoes,202503,152,243,528,923,1.954,"47,24%","7,78%"
352830,Sp-Magda,202503,250,470,698,1418,3.212,"44,15%","7,78%"
350370,Sp-Ariranha,202503,600,577,898,2075,7.653,"27,11%","7,84%"
354390,Sp-Rio Claro,202503,16390,11184,15475,43049,208.857,"20,61%","7,85%"
355320,Sp-Taiuva,202503,529,535,549,1613,6.733,"23,96%","7,86%"
352440,Sp-Jacarei,202503,19736,21547,20374,61657,249.968,"24,67%","7,90%"
353650,Sp-Paulinia,202503,9141,5898,6126,21165,115.690,"18,29%","7,90%"
350550,Sp-Barretos,202503,10020,8914,10311,29245,126.600,"23,10%","7,91%"
350040,Sp-Aguas da Prata,202503,592,816,911,2319,7.470,"31,04%","7,93%"
353790,Sp-Pilar do Sul,202503,2254,3857,2923,9034,28.417,"31,79%","7,93%"
352450,Sp-Jaci,202503,626,717,987,2330,7.878,"29,58%","7,95%"
354850,Sp-Santos,202503,34291,16427,19433,70151,429.567,"16,33%","7,98%"
354340,Sp-Ribeirao Preto,202503,58569,37243,41741,137553,728.400,"18,88%","8,04%"
354000,Sp-Pompeia,202503,1663,1772,3523,6958,20.512,"33,92%","8,11%"
350240,Sp-Anhumas,202503,336,644,988,1968,4.108,"47,91%","8,18%"
354625,Sp-Santa Cruz da Esperanca,202503,177,286,474,937,2.162,"43,34%","8,19%"
351660,Sp-Galia,202503,528,803,691,2022,6.435,"31,42%","8,21%"
353930,Sp-Pirassununga,202503,6223,5411,5491,17125,75.475,"22,69%","8,25%"
355645,Sp-Vargem Grande Paulista,202503,4296,3329,3480,11105,52.103,"21,31%","8,25%"
352960,Sp-Meridiano,202503,389,623,968,1980,4.697,"42,15%","8,28%"
353070,Sp-Mogi-Guacu,202503,13250,10768,13957,37975,159.735,"23,77%","8,29%"
352820,Sp-Macedonia,202503,336,521,417,1274,4.048,"31,47%","8,30%"
355450,Sp-Tiete,202503,3212,3127,4572,10911,38.690,"28,20%","8,30%"
351850,Sp-Guarei,202503,1269,1613,1779,4661,15.268,"30,53%","8,31%"
354940,Sp-Sao Joaquim da Barra,202503,4174,3218,3119,10511,49.815,"21,10%","8,38%"
351070,Sp-Cardoso,202503,964,1497,2029,4490,11.491,"39,07%","8,39%"
352520,Sp-Jarinu,202503,3323,2866,2537,8726,39.531,"22,07%","8,41%"
353284,Sp-Nova Canaa Paulista,202503,174,255,556,985,2.058,"47,86%","8,45%"
353810,Sp-Pindorama,202503,1247,1106,1731,4084,14.721,"27,74%","8,47%"
351750,Sp-Guapiacu,202503,1908,1559,2669,6136,22.316,"27,50%","8,55%"
353350,Sp-Novo Horizonte,202503,3382,4428,4505,12315,39.435,"31,23%","8,58%"
350600,Sp-Bauru,202503,33600,28703,36307,98610,391.740,"25,17%","8,58%"
351530,Sp-Estrela do Norte,202503,236,240,436,912,2.749,"33,18%","8,58%"
354120,Sp-Presidente Bernardes,202503,1276,1201,1821,4298,14.772,"29,10%","8,64%"
352710,Sp-Lins,202503,6629,4950,5078,16657,76.729,"21,71%","8,64%"
351690,Sp-General Salgado,202503,903,1072,1245,3220,10.449,"30,82%","8,64%"
354640,Sp-Santa Cruz do Rio Pardo,202503,4123,3808,2996,10927,47.677,"22,92%","8,65%"
350470,Sp-Balbinos,202503,343,81,153,577,3.963,"14,56%","8,66%"
350320,Sp-Araraquara,202503,21845,15266,17498,54609,252.318,"21,64%","8,66%"
352950,Sp-Mendonca,202503,554,583,754,1891,6.369,"29,69%","8,70%"
350075,Sp-Alambari,202503,551,794,761,2106,6.330,"33,27%","8,70%"
351385,Sp-Dirce Reis,202503,143,249,751,1143,1.641,"69,65%","8,71%"
351519,Sp-Espirito Santo do Turvo,202503,369,601,1060,2030,4.217,"48,14%","8,75%"
350070,Sp-Agudos,202503,3412,3443,3680,10535,38.879,"27,10%","8,78%"
354980,Sp-Sao Jose do Rio Preto,202503,44245,24760,34674,103679,501.597,"20,67%","8,82%"
352200,Sp-Itaju,202503,328,452,491,1271,3.702,"34,33%","8,86%"
351940,Sp-Ibira,202503,1061,1052,1092,3205,11.934,"26,86%","8,89%"
351140,Sp-Cerqueira Cesar,202503,1965,2608,2112,6685,22.076,"30,28%","8,90%"
351685,Sp-Gaviao Peixoto,202503,430,533,783,1746,4.797,"36,40%","8,96%"
354240,Sp-Regente Feijo,202503,1849,1633,2296,5778,20.565,"28,10%","8,99%"
350400,Sp-Assis,202503,9429,8294,9813,27536,104.642,"26,31%","9,01%"
355650,Sp-Varzea Paulista,202503,10791,7526,8299,26616,119.576,"22,26%","9,02%"
351580,Sp-Flora Rica,202503,135,201,352,688,1.492,"46,11%","9,05%"
353710,Sp-Pedreira,202503,4013,2783,4263,11059,44.332,"24,95%","9,05%"
354140,Sp-Presidente Prudente,202503,21262,16054,19163,56479,234.083,"24,13%","9,08%"
352115,Sp-Ipigua,202503,640,530,454,1624,7.037,"23,08%","9,09%"
355710,Sp-Votuporanga,202503,9161,7082,11122,27365,100.159,"27,32%","9,15%"
354470,Sp-Sagres,202503,231,390,568,1189,2.519,"47,20%","9,17%"
353010,Sp-Mirandopolis,202503,2637,1934,2916,7487,28.737,"26,05%","9,18%"
352930,Sp-Matao,202503,7442,5653,4650,17745,80.998,"21,91%","9,19%"
350740,Sp-Borborema,202503,1325,1611,1750,4686,14.415,"32,51%","9,19%"
354765,Sp-Santa Salete,202503,155,226,409,790,1.686,"46,86%","9,19%"
353520,Sp-Palmeira D Oeste,202503,828,980,1283,3091,8.994,"34,37%","9,21%"
354330,Sp-Ribeirao Pires,202503,10948,6689,8441,26078,118.877,"21,94%","9,21%"
354080,Sp-Potirendaba,202503,1759,1558,1930,5247,18.994,"27,62%","9,26%"
354890,Sp-Sao Carlos,202503,24576,14826,16225,55627,265.294,"20,97%","9,26%"
350280,Sp-Aracatuba,202503,19283,13475,17938,50696,207.775,"24,40%","9,28%"
353286,Sp-Nova Castilho,202503,100,171,205,476,1.074,"44,32%","9,31%"
352010,Sp-Igarapava,202503,2504,2541,2306,7351,26.755,"27,48%","9,36%"
351620,Sp-Franca,202503,34170,25695,22353,82218,364.331,"22,57%","9,38%"
350840,Sp-Cabreuva,202503,4551,3876,4029,12456,48.473,"25,70%","9,39%"
354060,Sp-Porto Feliz,202503,5478,3640,4545,13663,58.345,"23,42%","9,39%"
353420,Sp-Orindiuva,202503,583,490,613,1686,6.145,"27,44%","9,49%"
353960,Sp-Planalto,202503,423,897,951,2271,4.454,"50,99%","9,50%"
351550,Sp-Fernandopolis,202503,6988,5318,7734,20040,73.286,"27,34%","9,54%"
351960,Sp-Ibitinga,202503,5921,5022,4730,15673,61.908,"25,32%","9,56%"
355060,Sp-Sao Roque,202503,7809,6637,7363,21809,81.342,"26,81%","9,60%"
350380,Sp-Artur Nogueira,202503,5107,4480,5716,15303,53.157,"28,79%","9,61%"
354180,Sp-Queiroz,202503,322,461,760,1543,3.351,"46,05%","9,61%"
355500,Sp-Tupa,202503,6301,5632,7963,19896,65.416,"30,41%","9,63%"
353670,Sp-Pederneiras,202503,4455,4521,5121,14097,46.223,"30,50%","9,64%"
352500,Sp-Jandira,202503,11809,10549,13068,35426,121.988,"29,04%","9,68%"
355635,Sp-Vargem,202503,1052,1081,1303,3436,10.805,"31,80%","9,74%"
355270,Sp-Tabatinga,202503,1463,1277,1097,3837,14.994,"25,59%","9,76%"
350460,Sp-Bady Bassitt,202503,2831,2405,3209,8445,28.909,"29,21%","9,79%"
353715,Sp-Pedrinhas Paulista,202503,278,381,593,1252,2.838,"44,12%","9,80%"
355410,Sp-Taubate,202503,31536,22887,24648,79071,321.298,"24,61%","9,82%"
354870,Sp-Sao Bernardo do Campo,202503,82690,50766,67820,201276,840.499,"23,95%","9,84%"
353490,Sp-Pacaembu,202503,1500,604,814,2918,15.217,"19,18%","9,86%"
355380,Sp-Taquarituba,202503,2451,3503,2952,8906,24.863,"35,82%","9,86%"
352290,Sp-Itapui,202503,1380,1469,1885,4734,13.984,"33,85%","9,87%"
353000,Sp-Mira Estrela,202503,317,400,606,1323,3.199,"41,36%","9,91%"
355220,Sp-Sorocaba,202503,75077,45516,51504,172097,757.459,"22,72%","9,91%"
354750,Sp-Santa Rita do Passa Quatro,202503,2496,2126,3029,7651,25.060,"30,53%","9,96%"
350020,Sp-Adolfo,202503,447,560,846,1853,4.478,"41,38%","9,98%"
350760,Sp-Braganca Paulista,202503,18452,14797,17539,50788,184.634,"27,51%","9,99%"
350750,Sp-Botucatu,202503,15067,12685,11638,39390,150.442,"26,18%","10,02%"
353510,Sp-Palmares Paulista,202503,973,883,1621,3477,9.709,"35,81%","10,02%"
352110,Sp-Ipeuna,202503,703,770,932,2405,6.999,"34,36%","10,04%"
353050,Sp-Mococa,202503,6970,4612,5325,16907,69.324,"24,39%","10,05%"
354810,Sp-Santo Antonio do Jardim,202503,628,579,491,1698,6.237,"27,22%","10,07%"
355690,Sp-Vista Alegre do Alto,202503,839,898,960,2697,8.327,"32,39%","10,08%"
355010,Sp-Sao Manuel,202503,3858,3332,4946,12136,38.166,"31,80%","10,11%"
350890,Sp-Caiabu,202503,380,321,659,1360,3.745,"36,32%","10,15%"
355535,Sp-Ubarana,202503,554,625,593,1772,5.456,"32,48%","10,15%"
355210,Sp-Socorro,202503,4214,2369,3016,9599,41.405,"23,18%","10,18%"
355470,Sp-Torrinha,202503,968,765,1643,3376,9.484,"35,60%","10,21%"
352390,Sp-Itu,202503,17836,12737,16425,46998,174.561,"26,92%","10,22%"
354820,Sp-Santo Antonio do Pinhal,202503,746,1349,1026,3121,7.294,"42,79%","10,23%"
354760,Sp-Santa Rosa de Viterbo,202503,2430,1972,2294,6696,23.725,"28,22%","10,24%"
354730,Sp-Santana de Parnaiba,202503,16675,11287,11615,39577,162.341,"24,38%","10,27%"
353470,Sp-Ourinhos,202503,10983,8136,9612,28731,106.877,"26,88%","10,28%"
350530,Sp-Barra Bonita,202503,3617,2138,3233,8988,35.159,"25,56%","10,29%"
353400,Sp-Onda Verde,202503,507,580,521,1608,4.912,"32,74%","10,32%"
351600,Sp-Florida Paulista,202503,1368,1080,1241,3689,13.171,"28,01%","10,39%"
352965,Sp-Mesopolis,202503,208,324,305,837,1.988,"42,10%","10,46%"
352600,Sp-Junqueiropolis,202503,2186,1858,1982,6026,20.878,"28,86%","10,47%"
351515,Sp-Engenheiro Coelho,202503,2118,2716,3247,8081,20.139,"40,13%","10,52%"
355700,Sp-Votorantim,202503,13974,9066,7455,30495,132.849,"22,95%","10,52%"
354325,Sp-Ribeirao Grande,202503,797,1681,2126,4604,7.570,"60,82%","10,53%"
351300,Sp-Cotia,202503,30220,23752,23545,77517,287.004,"27,01%","10,53%"
353450,Sp-Oscar Bressane,202503,264,372,436,1072,2.504,"42,81%","10,54%"
355490,Sp-Tres Fronteiras,202503,741,719,1031,2491,7.013,"35,52%","10,57%"
350610,Sp-Bebedouro,202503,8306,5990,8003,22299,78.210,"28,51%","10,62%"
352740,Sp-Lucelia,202503,2168,1894,2226,6288,20.372,"30,87%","10,64%"
350290,Sp-Aracoiaba da Serra,202503,3587,3343,2620,9550,33.656,"28,38%","10,66%"
352380,Sp-Itobi,202503,877,952,906,2735,8.210,"33,31%","10,68%"
350850,Sp-Cacapava,202503,10662,8487,7516,26665,99.678,"26,75%","10,70%"
352940,Sp-Maua,202503,45966,26622,22225,94813,429.380,"22,08%","10,71%"
354900,Sp-Sao Francisco,202503,282,392,429,1103,2.629,"41,96%","10,73%"
351820,Sp-Guararapes,202503,3422,2681,3499,9602,31.872,"30,13%","10,74%"
354720,Sp-Santana da Ponte Pensa,202503,184,162,405,751,1.698,"44,23%","10,84%"
355610,Sp-Valentim Gentil,202503,1575,1636,2340,5551,14.531,"38,20%","10,84%"
353740,Sp-Pereira Barreto,202503,2649,2150,2275,7074,24.389,"29,00%","10,86%"
355395,Sp-Taruma,202503,1662,1529,1981,5172,15.248,"33,92%","10,90%"
352410,Sp-Ituverava,202503,4196,3191,3262,10649,38.451,"27,69%","10,91%"
354220,Sp-Rancharia,202503,3200,3116,3053,9369,29.305,"31,97%","10,92%"
350450,Sp-Avare,202503,10530,7585,7348,25463,96.098,"26,50%","10,96%"
354780,Sp-Santo Andre,202503,85509,40202,57440,183151,778.711,"23,52%","10,98%"
354160,Sp-Promissao,202503,3954,2651,2012,8617,35.991,"23,94%","10,99%"
355020,Sp-Sao Miguel Arcanjo,202503,3619,4415,2433,10467,32.904,"31,81%","11,00%"
352860,Sp-Manduri,202503,1110,1071,1311,3492,10.092,"34,60%","11,00%"
353410,Sp-Oriente,202503,680,303,523,1506,6.180,"24,37%","11,00%"
351860,Sp-Guariba,202503,4269,2674,2520,9463,38.609,"24,51%","11,06%"
352550,Sp-Joanopolis,202503,1450,1348,1252,4050,13.095,"30,93%","11,07%"
351270,Sp-Corumbatai,202503,475,408,657,1540,4.285,"35,94%","11,09%"
350950,Sp-Campinas,202503,131536,78426,98385,308347,1.185.977,"26,00%","11,09%"
355640,Sp-Vargem Grande do Sul,202503,4590,3653,4199,12442,41.226,"30,18%","11,13%"
353260,Sp-Nhandeara,202503,1110,837,1363,3310,9.944,"33,29%","11,16%"
351780,Sp-Guaracai,202503,838,872,1781,3491,7.486,"46,63%","11,19%"
354050,Sp-Porangaba,202503,1206,1288,1131,3625,10.773,"33,65%","11,19%"
355400,Sp-Tatui,202503,14400,10582,9141,34123,128.560,"26,54%","11,20%"
353610,Sp-Pardinho,202503,827,1003,1160,2990,7.382,"40,50%","11,20%"
355730,Sp-Estiva Gerbi,202503,1303,980,995,3278,11.566,"28,34%","11,27%"
352160,Sp-Irapuru,202503,807,792,1156,2755,7.145,"38,56%","11,29%"
355520,Sp-Turiuba,202503,208,304,435,947,1.839,"51,50%","11,31%"
355390,Sp-Tarabai,202503,751,710,653,2114,6.635,"31,86%","11,32%"
355050,Sp-Sao Pedro do Turvo,202503,831,1322,975,3128,7.333,"42,66%","11,33%"
351080,Sp-Casa Branca,202503,3265,2513,2250,8028,28.786,"27,89%","11,34%"
355360,Sp-Tapiratiba,202503,1369,1232,1091,3692,11.936,"30,93%","11,47%"
353280,Sp-Nova Alianca,202503,787,736,761,2284,6.858,"33,30%","11,48%"
355480,Sp-Tremembe,202503,6092,3873,3265,13230,53.083,"24,92%","11,48%"
355240,Sp-Sumare,202503,33309,17611,23776,74696,289.787,"25,78%","11,49%"
351560,Sp-Fernando Prestes,202503,698,604,700,2002,6.066,"33,00%","11,51%"
353150,Sp-Monte Azul Paulista,202503,2115,1316,1571,5002,18.363,"27,24%","11,52%"
352840,Sp-Mairinque,202503,5954,3846,3243,13043,51.660,"25,25%","11,53%"
351590,Sp-Floreal,202503,319,216,273,808,2.756,"29,32%","11,57%"
354020,Sp-Pontal,202503,4447,3697,4098,12242,38.376,"31,90%","11,59%"
355590,Sp-Uru,202503,165,151,137,453,1.419,"31,92%","11,63%"
351740,Sp-Guaira,202503,4719,2391,2105,9215,40.424,"22,80%","11,67%"
354800,Sp-Santo Antonio de Posse,202503,2781,2535,2820,8136,23.779,"34,22%","11,70%"
350520,Sp-Bariri,202503,3796,2658,2824,9278,32.405,"28,63%","11,71%"
352230,Sp-Itapetininga,202503,19229,17293,15290,51812,163.774,"31,64%","11,74%"
352360,Sp-Itirapina,202503,1932,1238,1219,4389,16.433,"26,71%","11,76%"
353860,Sp-Piracaia,202503,3149,3274,2270,8693,26.764,"32,48%","11,77%"
353820,Sp-Pinhalzinho,202503,1839,1741,2106,5686,15.605,"36,44%","11,78%"
350330,Sp-Araras,202503,15957,8056,11162,35175,135.331,"25,99%","11,79%"
353390,Sp-Olimpia,202503,6687,5155,8828,20670,56.701,"36,45%","11,79%"
354560,Sp-Santa Adelia,202503,1680,1400,3380,6460,14.203,"45,48%","11,83%"
351680,Sp-Gastao Vidigal,202503,383,471,543,1397,3.235,"43,18%","11,84%"
353950,Sp-Pitangueiras,202503,4093,3459,3487,11039,34.416,"32,08%","11,89%"
355230,Sp-Sud Mennucci,202503,889,842,1977,3708,7.466,"49,67%","11,91%"
350700,Sp-Boituva,202503,7556,4188,3888,15632,63.415,"24,65%","11,92%"
353140,Sp-Monte Aprazivel,202503,2715,2783,2967,8465,22.650,"37,37%","11,99%"
354630,Sp-Santa Cruz das Palmeiras,202503,3560,2848,2644,9052,29.525,"30,66%","12,06%"
352700,Sp-Lindoia,202503,864,744,987,2595,7.147,"36,31%","12,09%"
353300,Sp-Nova Granada,202503,2385,1952,2616,6953,19.725,"35,25%","12,09%"
354620,Sp-Santa Cruz da Conceicao,202503,529,443,636,1608,4.365,"36,84%","12,12%"
354860,Sp-Sao Bento do Sapucai,202503,1448,1558,1682,4688,11.948,"39,24%","12,12%"
350170,Sp-Americo Brasiliense,202503,4116,2306,2688,9110,33.757,"26,99%","12,19%"
354930,Sp-Sao Joao do Pau D Alho,202503,279,197,525,1001,2.288,"43,75%","12,19%"
354970,Sp-Sao Jose do Rio Pardo,202503,6523,3503,3629,13655,53.416,"25,56%","12,21%"
351410,Sp-Dois Corregos,202503,3037,2608,2622,8267,24.855,"33,26%","12,22%"
353360,Sp-Nuporanga,202503,923,594,494,2011,7.550,"26,64%","12,23%"
350080,Sp-Alfredo Marcondes,202503,558,587,1012,2157,4.556,"47,34%","12,25%"
351840,Sp-Guaratingueta,202503,14908,8456,7376,30740,121.710,"25,26%","12,25%"
351450,Sp-Duartina,202503,1536,1445,2101,5082,12.529,"40,56%","12,26%"
350120,Sp-Alvares Florence,202503,489,384,776,1649,3.978,"41,45%","12,29%"
355495,Sp-Tuiuti,202503,854,985,1057,2896,6.947,"41,69%","12,29%"
351907,Sp-Hortolandia,202503,30537,19492,22617,72646,247.331,"29,37%","12,35%"
351190,Sp-Clementina,202503,876,966,1063,2905,7.087,"40,99%","12,36%"
350250,Sp-Aparecida,202503,4107,4054,3764,11925,33.223,"35,89%","12,36%"
354100,Sp-Praia Grande,202503,45193,25449,22443,93085,365.577,"25,46%","12,36%"
351512,Sp-Emilianopolis,202503,379,418,542,1339,3.062,"43,73%","12,38%"
350395,Sp-Aspasia,202503,232,292,493,1017,1.873,"54,30%","12,39%"
355040,Sp-Sao Pedro,202503,4934,2446,2619,9999,39.725,"25,17%","12,42%"
353250,Sp-Neves Paulista,202503,1234,775,1051,3060,9.921,"30,84%","12,44%"
352880,Sp-Maracai,202503,1598,1160,1846,4604,12.826,"35,90%","12,46%"
352910,Sp-Marinopolis,202503,233,335,476,1044,1.870,"55,83%","12,46%"
352690,Sp-Limeira,202503,37537,17577,22194,77308,300.728,"25,71%","12,48%"
355300,Sp-Taguai,202503,1627,1943,1150,4720,13.006,"36,29%","12,51%"
355170,Sp-Sertaozinho,202503,16477,8720,10770,35967,131.600,"27,33%","12,52%"
354830,Sp-Santo Expedito,202503,384,349,657,1390,3.063,"45,38%","12,54%"
350900,Sp-Caieiras,202503,12320,6946,10034,29300,98.257,"29,82%","12,54%"
353220,Sp-Narandiba,202503,741,594,916,2251,5.908,"38,10%","12,54%"
351495,Sp-Embauba,202503,296,140,227,663,2.353,"28,18%","12,58%"
350590,Sp-Batatais,202503,7559,3737,5202,16498,59.873,"27,55%","12,63%"
354460,Sp-Sabino,202503,655,725,595,1975,5.185,"38,09%","12,63%"
352790,Sp-Lutecia,202503,341,439,604,1384,2.699,"51,28%","12,63%"
355260,Sp-Tabapua,202503,1453,934,1514,3901,11.499,"33,92%","12,64%"
350730,Sp-Boraceia,202503,610,691,761,2062,4.823,"42,75%","12,65%"
353730,Sp-Penapolis,202503,8019,4118,4520,16657,63.317,"26,31%","12,66%"
355715,Sp-Zacarias,202503,350,397,773,1520,2.761,"55,05%","12,68%"
355090,Sp-Sao Simao,202503,1726,1152,1338,4216,13.590,"31,02%","12,70%"
351430,Sp-Dourado,202503,1040,795,866,2701,8.186,"33,00%","12,70%"
350780,Sp-Brodosqui,202503,3326,1971,1968,7265,26.167,"27,76%","12,71%"
354540,Sp-Salto Grande,202503,1179,1254,1223,3656,9.212,"39,69%","12,80%"
352670,Sp-Leme,202503,12998,8711,10881,32590,101.316,"32,17%","12,83%"
354450,Sp-Rubineia,202503,509,452,779,1740,3.965,"43,88%","12,84%"
352190,Sp-Itajobi,202503,2252,1353,1376,4981,17.420,"28,59%","12,93%"
350210,Sp-Andradina,202503,7954,3971,6886,18811,61.473,"30,60%","12,94%"
352780,Sp-Lupercio,202503,521,690,1081,2292,4.017,"57,06%","12,97%"
350180,Sp-Americo de Campos,202503,778,516,899,2193,5.975,"36,70%","13,02%"
354990,Sp-Sao Jose dos Campos,202503,94382,55866,81371,231619,724.756,"31,96%","13,02%"
350260,Sp-Aparecida D Oeste,202503,538,603,1160,2301,4.124,"55,80%","13,05%"
350930,Sp-Cajobi,202503,1206,1099,1880,4185,9.232,"45,33%","13,06%"
355030,Sp-Sao Paulo,202503,1555964,957449,1136292,3649705,11.895.578,"30,68%","13,08%"
352430,Sp-Jaboticabal,202503,9686,5976,6928,22590,73.467,"30,75%","13,18%"
350360,Sp-Areiopolis,202503,1358,1038,1137,3533,10.257,"34,44%","13,24%"
353500,Sp-Palestina,202503,1550,913,1245,3708,11.689,"31,72%","13,26%"
350960,Sp-Campo Limpo Paulista,202503,10623,6399,7468,24490,79.663,"30,74%","13,33%"
350720,Sp-Bora,202503,124,136,224,484,928,"52,16%","13,36%"
353160,Sp-Monte Castelo,202503,575,463,836,1874,4.301,"43,57%","13,37%"
353200,Sp-Morungaba,202503,1888,1332,1339,4559,14.081,"32,38%","13,41%"
352885,Sp-Marapoama,202503,455,268,341,1064,3.392,"31,37%","13,41%"
354025,Sp-Pontalinda,202503,563,749,901,2213,4.196,"52,74%","13,42%"
350570,Sp-Barueri,202503,44341,33278,30179,107798,330.339,"32,63%","13,42%"
352640,Sp-Laranjal Paulista,202503,3628,2854,3345,9827,27.009,"36,38%","13,43%"
353600,Sp-Parapua,202503,1448,1378,1497,4323,10.729,"40,29%","13,50%"
354370,Sp-Rincao,202503,1236,876,764,2876,9.145,"31,45%","13,52%"
354420,Sp-Riolandia,202503,1414,1281,1500,4195,10.453,"40,13%","13,53%"
351310,Sp-Cravinhos,202503,4637,2806,3963,11406,34.252,"33,30%","13,54%"
354610,Sp-Santa Clara D Oeste,202503,363,333,715,1411,2.677,"52,71%","13,56%"
350140,Sp-Alvaro de Carvalho,202503,665,503,716,1884,4.896,"38,48%","13,58%"
355255,Sp-Suzanapolis,202503,471,450,1171,2092,3.464,"60,39%","13,60%"
353205,Sp-Motuca,202503,557,407,530,1494,4.079,"36,63%","13,66%"
354290,Sp-Ribeirao Bonito,202503,1514,1135,930,3579,11.079,"32,30%","13,67%"
352130,Sp-Ipua,202503,2017,1637,2769,6423,14.691,"43,72%","13,73%"
351670,Sp-Garca,202503,5951,4276,7966,18193,43.115,"42,20%","13,80%"
354130,Sp-Presidente Epitacio,202503,5574,4935,6990,17499,40.383,"43,33%","13,80%"
350090,Sp-Altair,202503,481,353,703,1537,3.479,"44,18%","13,83%"
354210,Sp-Rafard,202503,1263,756,1131,3150,9.133,"34,49%","13,83%"
351380,Sp-Diadema,202503,55959,28988,39791,124738,404.118,"30,87%","13,85%"
351010,Sp-Candido Rodrigues,202503,410,309,643,1362,2.951,"46,15%","13,89%"
354010,Sp-Pongai,202503,481,241,314,1036,3.443,"30,09%","13,97%"
354510,Sp-Salmourao,202503,683,684,768,2135,4.883,"43,72%","13,99%"
354030,Sp-Pontes Gestal,202503,338,295,766,1399,2.415,"57,93%","14,00%"
355630,Sp-Valparaiso,202503,3463,2003,2983,8449,24.723,"34,17%","14,01%"
352750,Sp-Lucianopolis,202503,339,284,616,1239,2.419,"51,22%","14,01%"
352040,Sp-Ilhabela,202503,5092,4052,4639,13783,36.329,"37,94%","14,02%"
355280,Sp-Taboao da Serra,202503,39934,23780,30914,94628,284.274,"33,29%","14,05%"
353440,Sp-Osasco,202503,106743,64163,79260,250166,756.952,"33,05%","14,10%"
355370,Sp-Taquaritinga,202503,7530,4543,4796,16869,53.322,"31,64%","14,12%"
354200,Sp-Quintana,202503,1022,749,872,2643,7.225,"36,58%","14,15%"
351980,Sp-Icem,202503,1128,753,1276,3157,7.969,"39,62%","14,15%"
352350,Sp-Itatinga,202503,2751,2287,2538,7576,19.427,"39,00%","14,16%"
351720,Sp-Guaicara,202503,1623,1180,1563,4366,11.459,"38,10%","14,16%"
351330,Sp-Cruzalia,202503,303,209,351,863,2.129,"40,54%","14,23%"
350680,Sp-Bocaina,202503,1636,933,1229,3798,11.467,"33,12%","14,27%"
352490,Sp-Jambeiro,202503,941,734,849,2524,6.575,"38,39%","14,31%"
352510,Sp-Jardinopolis,202503,6714,3474,3961,14149,46.868,"30,19%","14,33%"
351100,Sp-Castilho,202503,2932,2485,4198,9615,20.418,"47,09%","14,36%"
350200,Sp-Analandia,202503,674,486,532,1692,4.684,"36,12%","14,39%"
351250,Sp-Coroados,202503,792,778,1472,3042,5.498,"55,33%","14,41%"
350690,Sp-Bofete,202503,1540,1406,1713,4659,10.688,"43,59%","14,41%"
351460,Sp-Dumont,202503,1402,752,881,3035,9.719,"31,23%","14,43%"
354110,Sp-Presidente Alves,202503,555,413,480,1448,3.841,"37,70%","14,45%"
355340,Sp-Tanabi,202503,3785,3067,3612,10464,26.021,"40,21%","14,55%"
354170,Sp-Quata,202503,1950,1674,2301,5925,13.399,"44,22%","14,55%"
352760,Sp-Luis Antonio,202503,1829,1276,1330,4435,12.531,"35,39%","14,60%"
353880,Sp-Piraju,202503,4440,2535,2258,9233,30.261,"30,51%","14,67%"
350620,Sp-Bento de Abreu,202503,389,262,565,1216,2.642,"46,03%","14,72%"
351700,Sp-Getulina,202503,1526,898,1011,3435,10.355,"33,17%","14,74%"
355720,Sp-Chavantes,202503,1833,1316,1269,4418,12.411,"35,60%","14,77%"
351890,Sp-Guzolandia,202503,632,725,919,2276,4.276,"53,23%","14,78%"
352180,Sp-Itai,202503,3835,2668,2539,9042,25.930,"34,87%","14,79%"
351040,Sp-Capivari,202503,7592,3471,4356,15419,51.318,"30,05%","14,79%"
352090,Sp-Ipaucu,202503,2068,1470,1320,4858,13.933,"34,87%","14,84%"
353620,Sp-Pariquera-Acu,202503,2908,3105,2730,8743,19.576,"44,66%","14,85%"
355190,Sp-Severinia,202503,2192,1671,2128,5991,14.724,"40,69%","14,89%"
355530,Sp-Turmalina,202503,249,142,367,758,1.672,"45,33%","14,89%"
350670,Sp-Boa Esperanca do Sul,202503,1972,1658,1931,5561,13.135,"42,34%","15,01%"
353215,Sp-Nantes,202503,406,335,386,1127,2.699,"41,76%","15,04%"
353625,Sp-Parisi,202503,453,414,889,1756,3.001,"58,51%","15,09%"
353580,Sp-Paranapanema,202503,3006,2014,1462,6482,19.799,"32,74%","15,18%"
350880,Sp-Cafelandia,202503,2582,1413,1427,5422,16.905,"32,07%","15,27%"
351090,Sp-Cassia dos Coqueiros,202503,437,292,241,970,2.855,"33,98%","15,31%"
352100,Sp-Ipero,202503,5820,3863,3962,13645,37.999,"35,91%","15,32%"
351030,Sp-Capela do Alto,202503,3616,3691,2701,10008,23.597,"42,41%","15,32%"
353190,Sp-Morro Agudo,202503,4381,2477,3500,10358,28.561,"36,27%","15,34%"
354650,Sp-Santa Ernestina,202503,962,396,830,2188,6.256,"34,97%","15,38%"
350055,Sp-Aguas de Santa Barbara,202503,1143,687,775,2605,7.407,"35,17%","15,43%"
353230,Sp-Natividade da Serra,202503,1111,1024,564,2699,7.134,"37,83%","15,57%"
350310,Sp-Arandu,202503,1098,967,1135,3200,7.050,"45,39%","15,57%"
354530,Sp-Salto de Pirapora,202503,7036,4543,5304,16883,45.138,"37,40%","15,59%"
350150,Sp-Alvinlandia,202503,456,469,556,1481,2.923,"50,67%","15,60%"
353850,Sp-Piquete,202503,1961,1335,1245,4541,12.570,"36,13%","15,60%"
353680,Sp-Pedra Bela,202503,1049,562,474,2085,6.718,"31,04%","15,61%"
352070,Sp-Indiapora,202503,644,527,907,2078,4.109,"50,57%","15,67%"
353890,Sp-Pirajui,202503,3567,1585,2848,8000,22.743,"35,18%","15,68%"
353800,Sp-Pindamonhangaba,202503,27034,14777,13564,55375,172.027,"32,19%","15,71%"
353560,Sp-Paraibuna,202503,2823,2322,1771,6916,17.950,"38,53%","15,73%"
355150,Sp-Serrana,202503,7146,4022,3970,15138,45.408,"33,34%","15,74%"
350940,Sp-Cajuru,202503,3816,1932,1952,7700,24.217,"31,80%","15,76%"
353020,Sp-Mirante do Paranapanema,202503,2559,2422,3825,8806,16.069,"54,80%","15,93%"
354090,Sp-Pradopolis,202503,2762,1231,1166,5159,17.309,"29,81%","15,96%"
351170,Sp-Charqueada,202503,2530,1221,1337,5088,15.798,"32,21%","16,01%"
352980,Sp-Mineiros do Tiete,202503,1819,1246,1288,4353,11.349,"38,36%","16,03%"
352870,Sp-Maraba Paulista,202503,746,636,808,2190,4.627,"47,33%","16,12%"
353320,Sp-Nova Independencia,202503,775,524,763,2062,4.795,"43,00%","16,16%"
350220,Sp-Angatuba,202503,3965,2982,3603,10550,24.512,"43,04%","16,18%"
350830,Sp-Cabralia Paulista,202503,707,689,1099,2495,4.362,"57,20%","16,21%"
352920,Sp-Martinopolis,202503,4109,1706,2311,8126,25.299,"32,12%","16,24%"
354040,Sp-Populina,202503,681,471,686,1838,4.185,"43,92%","16,27%"
350130,Sp-Alvares Machado,202503,4604,2667,2670,9941,28.250,"35,19%","16,30%"
353657,Sp-Paulistania,202503,350,298,325,973,2.146,"45,34%","16,31%"
351610,Sp-Florinea,202503,653,302,610,1565,3.987,"39,25%","16,38%"
353180,Sp-Monte Mor,202503,11025,8581,10006,29612,67.296,"44,00%","16,38%"
350630,Sp-Bernardino de Campos,202503,1944,1144,1644,4732,11.852,"39,93%","16,40%"
351925,Sp-Iaras,202503,1355,770,1020,3145,8.257,"38,09%","16,41%"
350870,Sp-Caconde,202503,2835,2680,2600,8115,17.266,"47,00%","16,42%"
354770,Sp-Santo Anastacio,202503,2966,1604,2195,6765,18.045,"37,49%","16,44%"
353630,Sp-Patrocinio Paulista,202503,2441,1638,1661,5740,14.837,"38,69%","16,45%"
351340,Sp-Cruzeiro,202503,12603,6070,5462,24135,76.513,"31,54%","16,47%"
351790,Sp-Guaraci,202503,1739,1257,1613,4609,10.542,"43,72%","16,50%"
354710,Sp-Santa Mercedes,202503,497,421,657,1575,3.012,"52,29%","16,50%"
350335,Sp-Arco-Iris,202503,345,383,369,1097,2.085,"52,61%","16,55%"
355000,Sp-Sao Luis do Paraitinga,202503,1741,1341,1128,4210,10.497,"40,11%","16,59%"
351870,Sp-Guaruja,202503,48930,23852,22701,95483,294.973,"32,37%","16,59%"
351492,Sp-Elisiario,202503,529,166,330,1025,3.189,"32,14%","16,59%"
351060,Sp-Carapicuiba,202503,66107,33094,38639,137840,398.462,"34,59%","16,59%"
351540,Sp-Fartura,202503,2819,2278,2707,7804,16.984,"45,95%","16,60%"
351230,Sp-Conchas,202503,2560,1745,2303,6608,15.381,"42,96%","16,64%"
354360,Sp-Rifaina,202503,694,433,534,1661,4.158,"39,95%","16,69%"
353330,Sp-Nova Luzitania,202503,474,443,831,1748,2.838,"61,59%","16,70%"
354805,Sp-Santo Antonio do Aracangua,202503,1435,860,1319,3614,8.568,"42,18%","16,75%"
352420,Sp-Jaborandi,202503,1055,594,1075,2724,6.293,"43,29%","16,76%"
353700,Sp-Pedregulho,202503,2644,1798,1841,6283,15.742,"39,91%","16,80%"
352720,Sp-Lorena,202503,14778,7180,5783,27741,87.370,"31,75%","16,91%"
350340,Sp-Arealva,202503,1402,933,1296,3631,8.280,"43,85%","16,93%"
351565,Sp-Fernao,202503,287,212,258,757,1.689,"44,82%","16,99%"
351770,Sp-Guara,202503,3202,1596,1872,6670,18.790,"35,50%","17,04%"
352000,Sp-Igaracu do Tiete,202503,3999,2034,2265,8298,23.430,"35,42%","17,07%"
351050,Sp-Caraguatatuba,202503,24093,14810,14802,53705,141.084,"38,07%","17,08%"
350300,Sp-Aramina,202503,944,434,851,2229,5.526,"40,34%","17,08%"
353060,Sp-Mogi das Cruzes,202503,80098,34542,34340,148980,468.120,"31,83%","17,11%"
355290,Sp-Taciba,202503,1095,852,1197,3144,6.399,"49,13%","17,11%"
354600,Sp-Santa Branca,202503,2460,1769,2323,6552,14.212,"46,10%","17,31%"
351350,Sp-Cubatao,202503,19941,9366,12798,42105,115.082,"36,59%","17,33%"
352810,Sp-Macaubal,202503,1318,748,1233,3299,7.587,"43,48%","17,37%"
350500,Sp-Barao de Antonina,202503,631,601,604,1836,3.618,"50,75%","17,44%"
351990,Sp-Iepe,202503,1352,997,1251,3600,7.739,"46,52%","17,47%"
350945,Sp-Campina do Monte Alegre,202503,1062,999,1026,3087,6.077,"50,80%","17,48%"
353090,Sp-Mombuca,202503,670,625,564,1859,3.815,"48,73%","17,56%"
351400,Sp-Dobrada,202503,1575,982,1391,3948,8.958,"44,07%","17,58%"
351920,Sp-Iacri,202503,1093,809,898,2800,6.207,"45,11%","17,61%"
352240,Sp-Itapeva,202503,16260,10149,9277,35686,92.324,"38,65%","17,61%"
354425,Sp-Rosana,202503,3088,1838,2466,7392,17.533,"42,16%","17,61%"
350920,Sp-Cajamar,202503,17189,9660,11005,37854,97.363,"38,88%","17,65%"
353380,Sp-Oleo,202503,449,276,329,1054,2.540,"41,50%","17,68%"
354680,Sp-Santa Isabel,202503,9656,4137,4666,18459,54.586,"33,82%","17,69%"
354700,Sp-Santa Maria da Serra,202503,941,740,974,2655,5.314,"49,96%","17,71%"
355310,Sp-Taiacu,202503,1019,634,672,2325,5.751,"40,43%","17,72%"
354840,Sp-Santopolis do Aguapei,202503,697,492,678,1867,3.933,"47,47%","17,72%"
351015,Sp-Canitar,202503,1161,1035,1217,3413,6.524,"52,31%","17,80%"
353990,Sp-Poloni,202503,1021,566,922,2509,5.696,"44,05%","17,92%"
350390,Sp-Aruja,202503,16124,8928,10717,35769,89.943,"39,77%","17,93%"
353530,Sp-Palmital,202503,3550,1627,1917,7094,19.767,"35,89%","17,96%"
350030,Sp-Aguai,202503,5930,3350,3097,12377,32.888,"37,63%","18,03%"
352060,Sp-Indiana,202503,937,637,710,2284,5.191,"44,00%","18,05%"
350110,Sp-Alto Alegre,202503,701,298,593,1592,3.883,"41,00%","18,05%"
352850,Sp-Mairipora,202503,17686,8282,10536,36504,97.399,"37,48%","18,16%"
352630,Sp-Lagoinha,202503,943,667,542,2152,5.182,"41,53%","18,20%"
352170,Sp-Itabera,202503,3331,2918,2833,9082,18.258,"49,74%","18,24%"
354320,Sp-Ribeirao do Sul,202503,872,642,808,2322,4.768,"48,70%","18,29%"
352540,Sp-Jeriquara,202503,728,550,534,1812,3.976,"45,57%","18,31%"
353550,Sp-Paraguacu Paulista,202503,7731,3928,5163,16822,42.087,"39,97%","18,37%"
350810,Sp-Buritama,202503,3234,1868,2365,7467,17.597,"42,43%","18,38%"
351880,Sp-Guarulhos,202503,247485,115615,145477,508577,1.345.364,"37,80%","18,40%"
352560,Sp-Joao Ramalho,202503,820,484,586,1890,4.456,"42,41%","18,40%"
354323,Sp-Ribeirao dos Indios,202503,377,248,497,1122,2.045,"54,87%","18,44%"
351570,Sp-Ferraz de Vasconcelos,202503,34268,16318,19064,69650,185.622,"37,52%","18,46%"
351220,Sp-Conchal,202503,5361,2823,3032,11216,29.034,"38,63%","18,46%"
353325,Sp-Novais,202503,826,603,978,2407,4.469,"53,86%","18,48%"
354440,Sp-Rubiacea,202503,508,438,803,1749,2.741,"63,81%","18,53%"
352250,Sp-Itapevi,202503,44941,27569,24911,97421,241.924,"40,27%","18,58%"
354085,Sp-Pracinha,202503,484,168,272,924,2.599,"35,55%","18,62%"
355120,Sp-Sarutaia,202503,702,718,769,2189,3.769,"58,08%","18,63%"
355100,Sp-Sao Vicente,202503,63099,23066,22333,108498,338.407,"32,06%","18,65%"
355420,Sp-Tejupa,202503,774,738,453,1965,4.142,"47,44%","18,69%"
355330,Sp-Tambau,202503,4059,1924,2474,8457,21.682,"39,00%","18,72%"
350100,Sp-Altinopolis,202503,3216,1743,2418,7377,17.156,"43,00%","18,75%"
355550,Sp-Ubirajara,202503,991,668,558,2217,5.265,"42,11%","18,82%"
352890,Sp-Mariapolis,202503,667,284,664,1615,3.539,"45,63%","18,85%"
351910,Sp-Iacanga,202503,2016,1227,1660,4903,10.633,"46,11%","18,96%"
355250,Sp-Suzano,202503,60465,31677,36940,129082,318.765,"40,49%","18,97%"
351290,Sp-Cosmorama,202503,1706,727,1402,3835,8.968,"42,76%","19,02%"
351020,Sp-Capao Bonito,202503,9111,6972,6724,22807,47.403,"48,11%","19,22%"
353040,Sp-Mirassolandia,202503,920,401,587,1908,4.771,"39,99%","19,28%"
355430,Sp-Teodoro Sampaio,202503,4355,2201,2779,9335,22.559,"41,38%","19,30%"
354260,Sp-Registro,202503,11956,7016,7161,26133,61.732,"42,33%","19,37%"
354410,Sp-Rio Grande da Serra,202503,8797,4555,5865,19217,45.317,"42,41%","19,41%"
355070,Sp-Sao Sebastiao,202503,16312,8757,8787,33856,84.019,"40,30%","19,41%"
352460,Sp-Jacupiranga,202503,3158,2735,2094,7987,16.254,"49,14%","19,43%"
351490,Sp-Elias Fausto,202503,3530,1713,1867,7110,18.103,"39,28%","19,50%"
351640,Sp-Franco da Rocha,202503,29288,14493,17462,61243,149.786,"40,89%","19,55%"
350860,Sp-Cachoeira Paulista,202503,6371,2692,2516,11579,32.482,"35,65%","19,61%"
353270,Sp-Nipoa,202503,961,672,791,2424,4.860,"49,88%","19,77%"
352150,Sp-Irapua,202503,1379,601,752,2732,6.946,"39,33%","19,85%"
350745,Sp-Borebi,202503,555,409,838,1802,2.787,"64,66%","19,91%"
354790,Sp-Santo Antonio da Alegria,202503,1379,908,670,2957,6.917,"42,75%","19,94%"
350910,Sp-Caiua,202503,1114,541,697,2352,5.585,"42,11%","19,95%"
354500,Sp-Salesopolis,202503,3079,2304,2090,7473,15.396,"48,54%","20,00%"
351730,Sp-Guaimbe,202503,1122,704,900,2726,5.606,"48,63%","20,01%"
354480,Sp-Sales,202503,1329,814,1499,3642,6.612,"55,08%","20,10%"
353210,Sp-Murutinga do Sul,202503,758,381,735,1874,3.763,"49,80%","20,14%"
351900,Sp-Herculandia,202503,1877,1059,1131,4067,9.302,"43,72%","20,18%"
350925,Sp-Cajati,202503,5926,3980,3734,13640,29.257,"46,62%","20,25%"
354550,Sp-Sandovalina,202503,750,529,578,1857,3.699,"50,20%","20,28%"
351885,Sp-Guatapara,202503,1514,601,653,2768,7.462,"37,09%","20,29%"
350710,Sp-Bom Jesus dos Perdoes,202503,4589,2351,2668,9608,22.501,"42,70%","20,39%"
351830,Sp-Guararema,202503,6629,3390,4664,14683,32.436,"45,27%","20,44%"
351390,Sp-Divinolandia,202503,2313,790,967,4070,11.314,"35,97%","20,44%"
354190,Sp-Queluz,202503,1900,1191,1476,4567,9.146,"49,93%","20,77%"
353780,Sp-Piedade,202503,11299,5288,4659,21246,54.237,"39,17%","20,83%"
351260,Sp-Coronel Macedo,202503,901,649,542,2092,4.295,"48,71%","20,98%"
350820,Sp-Buritizal,202503,933,515,1154,2602,4.447,"58,51%","20,98%"
354430,Sp-Roseira,202503,2328,1217,1572,5117,11.095,"46,12%","20,98%"
353660,Sp-Paulo de Faria,202503,1559,559,1013,3131,7.430,"42,14%","20,98%"
354270,Sp-Restinga,202503,1367,901,869,3137,6.492,"48,32%","21,06%"
351930,Sp-Ibate,202503,6975,3134,2971,13080,33.110,"39,50%","21,07%"
352020,Sp-Igarata,202503,2307,1302,1405,5014,10.904,"45,98%","21,16%"
353310,Sp-Nova Guataporanga,202503,463,241,358,1062,2.188,"48,54%","21,16%"
355570,Sp-Uniao Paulista,202503,345,199,388,932,1.628,"57,25%","21,19%"
354075,Sp-Potim,202503,4403,2489,1860,8752,20.767,"42,14%","21,20%"
353830,Sp-Piquerobi,202503,699,478,409,1586,3.296,"48,12%","21,21%"
352725,Sp-Lourdes,202503,418,297,519,1234,1.968,"62,70%","21,24%"
352300,Sp-Itapura,202503,860,576,1236,2672,4.014,"66,57%","21,43%"
352320,Sp-Itarare,202503,9725,5355,5498,20578,45.327,"45,40%","21,46%"
351210,Sp-Colombia,202503,1457,861,1380,3698,6.781,"54,53%","21,49%"
351710,Sp-Glicerio,202503,907,579,784,2270,4.173,"54,40%","21,73%"
350275,Sp-Aracariguama,202503,4826,2468,2604,9898,22.168,"44,65%","21,77%"
351535,Sp-Euclides da Cunha Paulista,202503,1737,1147,1313,4197,7.928,"52,94%","21,91%"
355140,Sp-Serra Azul,202503,2869,1019,1103,4991,13.058,"38,22%","21,97%"
353370,Sp-Ocaucu,202503,970,624,513,2107,4.412,"47,76%","21,99%"
351760,Sp-Guapiara,202503,3795,3325,2643,9763,17.256,"56,58%","21,99%"
353720,Sp-Pedro de Toledo,202503,2545,1522,1340,5407,11.539,"46,86%","22,06%"
350775,Sp-Brejo Alegre,202503,576,450,884,1910,2.605,"73,32%","22,11%"
353240,Sp-Nazare Paulista,202503,4143,1945,1712,7800,18.620,"41,89%","22,25%"
350440,Sp-Avanhandava,202503,2545,1585,1870,6000,11.438,"52,46%","22,25%"
350270,Sp-Apiai,202503,5553,3365,3308,12226,24.886,"49,13%","22,31%"
350430,Sp-Avai,202503,1014,597,538,2149,4.519,"47,55%","22,44%"
355460,Sp-Timburi,202503,560,374,481,1415,2.490,"56,83%","22,49%"
353110,Sp-Mongagua,202503,14617,6235,5102,25954,64.519,"40,23%","22,66%"
354960,Sp-Sao Jose do Barreiro,202503,894,845,631,2370,3.898,"60,80%","22,93%"
355130,Sp-Sebastianopolis do Sul,202503,731,266,987,1984,3.187,"62,25%","22,94%"
352660,Sp-Lavrinhas,202503,1681,897,785,3363,7.328,"45,89%","22,94%"
354105,Sp-Pratania,202503,1204,835,1170,3209,5.246,"61,17%","22,95%"
351420,Sp-Dolcinopolis,202503,517,279,583,1379,2.250,"61,29%","22,98%"
353590,Sp-Paranapua,202503,947,452,562,1961,4.111,"47,70%","23,04%"
350560,Sp-Barrinha,202503,7651,2730,3002,13383,33.181,"40,33%","23,06%"
355540,Sp-Ubatuba,202503,22458,8632,8158,39248,96.598,"40,63%","23,25%"
353640,Sp-Pauliceia,202503,1910,915,1254,4079,8.200,"49,74%","23,29%"
352610,Sp-Juquia,202503,4022,2593,2039,8654,17.255,"50,15%","23,31%"
353540,Sp-Panorama,202503,3552,1416,1685,6653,15.214,"43,73%","23,35%"
352280,Sp-Itaporanga,202503,3335,1688,1564,6587,14.260,"46,19%","23,39%"
350770,Sp-Brauna,202503,1290,499,916,2705,5.466,"49,49%","23,60%"
350660,Sp-Biritiba-Mirim,202503,7213,3803,3790,14806,30.526,"48,50%","23,63%"
351470,Sp-Echapora,202503,1489,782,1061,3332,6.295,"52,93%","23,65%"
351970,Sp-Ibiuna,202503,18409,9113,7954,35476,77.651,"45,69%","23,71%"
353980,Sp-Poa,202503,25257,10314,14092,49663,106.431,"46,66%","23,73%"
350490,Sp-Bananal,202503,2407,1662,1746,5815,10.109,"57,52%","23,81%"
351360,Sp-Cunha,202503,5377,3592,2243,11212,22.456,"49,93%","23,94%"
352310,Sp-Itaquaquecetuba,202503,91737,38120,38954,168811,382.521,"44,13%","23,98%"
351810,Sp-Guaranta,202503,1573,789,989,3351,6.531,"51,31%","24,09%"
355350,Sp-Tapirai,202503,1964,1304,1132,4400,8.122,"54,17%","24,18%"
352220,Sp-Itapecerica da Serra,202503,39762,18930,24666,83358,163.928,"50,85%","24,26%"
355475,Sp-Trabiju,202503,419,257,323,999,1.719,"58,12%","24,37%"
351500,Sp-Embu,202503,63403,26989,35276,125668,259.323,"48,46%","24,45%"
352580,Sp-Julio Mesquita,202503,1060,443,621,2124,4.308,"49,30%","24,61%"
354230,Sp-Redencao da Serra,202503,1135,596,491,2222,4.611,"48,19%","24,62%"
351630,Sp-Francisco Morato,202503,42364,19732,21179,83275,171.107,"48,67%","24,76%"
351480,Sp-Eldorado,202503,3261,2422,1733,7416,13.162,"56,34%","24,78%"
355385,Sp-Taquarivai,202503,1778,1219,1026,4023,7.112,"56,57%","25,00%"
352330,Sp-Itariri,202503,3944,1810,1573,7327,15.762,"46,49%","25,02%"
350980,Sp-Campos Novos Paulista,202503,1250,452,516,2218,4.991,"44,44%","25,05%"
355200,Sp-Silveiras,202503,1587,937,674,3198,6.313,"50,66%","25,14%"
351510,Sp-Embu-Guacu,202503,17357,7786,11321,36464,68.805,"53,00%","25,23%"
354995,Sp-Sao Lourenco da Serra,202503,4172,1330,2113,7615,16.458,"46,27%","25,35%"
353910,Sp-Pirapora do Bom Jesus,202503,4854,2146,2212,9212,18.836,"48,91%","25,77%"
350635,Sp-Bertioga,202503,17287,6897,8257,32441,66.873,"48,51%","25,85%"
353760,Sp-Peruibe,202503,18893,9203,8602,36698,70.543,"52,02%","26,78%"
350510,Sp-Barbosa,202503,1530,740,1051,3321,5.659,"58,69%","27,04%"
352210,Sp-Itanhaem,202503,31943,12770,13911,58624,117.435,"49,92%","27,20%"
352770,Sp-Luiziania,202503,1296,542,882,2720,4.751,"57,25%","27,28%"
352970,Sp-Miguelopolis,202503,5379,1501,1906,8786,19.655,"44,70%","27,37%"
354950,Sp-Sao Jose da Bela Vista,202503,2110,876,916,3902,7.690,"50,74%","27,44%"
353282,Sp-Nova Campina,202503,2409,1656,1383,5448,8.631,"63,12%","27,91%"
352620,Sp-Juquitiba,202503,7873,4514,4416,16803,28.007,"60,00%","28,11%"
354165,Sp-Quadra,202503,977,637,533,2147,3.472,"61,84%","28,14%"
354350,Sp-Riversul,202503,1594,1023,940,3557,5.647,"62,99%","28,23%"
353480,Sp-Ouro Verde,202503,2232,918,966,4116,7.901,"52,09%","28,25%"
353170,Sp-Monteiro Lobato,202503,1193,481,614,2288,4.205,"54,41%","28,37%"
350230,Sp-Anhembi,202503,1636,731,860,3227,5.766,"55,97%","28,37%"
352215,Sp-Itaoca,202503,991,523,648,2162,3.490,"61,95%","28,40%"
350350,Sp-Areias,202503,1037,523,389,1949,3.625,"53,77%","28,61%"
352370,Sp-Itirapua,202503,1696,833,581,3110,5.861,"53,06%","28,94%"
353970,Sp-Platina,202503,890,365,443,1698,3.061,"55,47%","29,08%"
352120,Sp-Iporanga,202503,1204,706,680,2590,4.091,"63,31%","29,43%"
355465,Sp-Torre de Pedra,202503,609,370,364,1343,2.063,"65,10%","29,52%"
354310,Sp-Ribeirao Corrente,202503,1398,615,549,2562,4.706,"54,44%","29,71%"
350990,Sp-Cananeia,202503,3722,1439,1319,6480,12.489,"51,89%","29,80%"
351950,Sp-Ibirarema,202503,1958,763,928,3649,6.461,"56,48%","30,30%"
352030,Sp-Iguape,202503,9197,3870,3766,16833,29.881,"56,33%","30,78%"
350315,Sp-Arapei,202503,726,469,725,1920,2.355,"81,53%","30,83%"
350995,Sp-Canas,202503,1560,837,651,3048,5.049,"60,37%","30,90%"
354300,Sp-Ribeirao Branco,202503,5875,3613,2360,11848,18.930,"62,59%","31,04%"
355180,Sp-Sete Barras,202503,4046,2136,1863,8045,12.912,"62,31%","31,34%"
354280,Sp-Ribeira,202503,1009,522,505,2036,3.166,"64,31%","31,87%"
352990,Sp-Miracatu,202503,6232,2854,3066,12152,18.679,"65,06%","33,36%"
350800,Sp-Buri,202503,7138,2925,2188,12251,20.674,"59,26%","34,53%"
352042,Sp-Ilha Comprida,202503,4855,2391,3629,10875,13.955,"77,93%","34,79%"
350715,Sp-Bom Sucesso de Itarare,202503,1279,650,488,2417,3.610,"66,95%","35,43%"
352265,Sp-Itapirapua Paulista,202503,1680,841,373,2894,4.405,"65,70%","38,14%"
350540,Sp-Barra do Turvo,202503,2837,991,1147,4975,6.922,"71,87%","40,99%"
350535,Sp-Barra do Chapeu,202503,2540,1012,848,4400,5.256,"83,71%","48,33%"
410010,Pr-Abatia,202503,1049,1344,1059,3452,7.271,"47,48%","14,43%"
410020,Pr-Adrianopolis,202503,1264,1221,1287,3772,6.327,"59,62%","19,98%"
410030,Pr-Agudos do Sul,202503,2473,1604,1273,5350,10.646,"50,25%","23,23%"
410040,Pr-Almirante Tamandare,202503,15402,17368,16349,49119,124.788,"39,36%","12,34%"
410045,Pr-Altamira do Parana,202503,618,769,755,2142,3.543,"60,46%","17,44%"
410050,Pr-Altonia,202503,1545,2186,2046,5777,18.750,"30,81%","8,24%"
410060,Pr-Alto Parana,202503,2561,2035,1758,6354,14.138,"44,94%","18,11%"
410070,Pr-Alto Piquiri,202503,1347,1745,2136,5228,9.802,"53,34%","13,74%"
410080,Pr-Alvorada do Sul,202503,1715,1221,1443,4379,10.478,"41,79%","16,37%"
410090,Pr-Amapora,202503,1182,892,866,2940,4.736,"62,08%","24,96%"
410100,Pr-Ampere,202503,802,2752,3019,6573,20.199,"32,54%","3,97%"
410105,Pr-Anahy,202503,483,431,725,1639,2.965,"55,28%","16,29%"
410110,Pr-Andira,202503,3928,2075,2101,8104,20.044,"40,43%","19,60%"
410115,Pr-Angulo,202503,379,532,478,1389,3.332,"41,69%","11,37%"
410120,Pr-Antonina,202503,5329,2214,1955,9498,18.223,"52,12%","29,24%"
410130,Pr-Antonio Olinto,202503,2263,817,763,3843,7.071,"54,35%","32,00%"
410140,Pr-Apucarana,202503,14384,14290,19086,47760,134.306,"35,56%","10,71%"
410150,Pr-Arapongas,202503,9635,10753,16870,37258,123.863,"30,08%","7,78%"
410160,Pr-Arapoti,202503,2949,3429,2900,9278,26.310,"35,26%","11,21%"
410165,Pr-Arapua,202503,728,551,632,1911,3.573,"53,48%","20,38%"
410170,Pr-Araruna,202503,1661,2199,4170,8030,14.824,"54,17%","11,20%"
410180,Pr-Araucaria,202503,18875,17278,20893,57046,160.038,"35,65%","11,79%"
410185,Pr-Ariranha do Ivai,202503,335,530,531,1396,2.351,"59,38%","14,25%"
410190,Pr-Assai,202503,1181,2472,2163,5816,13.643,"42,63%","8,66%"
410200,Pr-Assis Chateaubriand,202503,3093,4505,6736,14334,38.105,"37,62%","8,12%"
410210,Pr-Astorga,202503,2066,3236,3232,8534,26.145,"32,64%","7,90%"
410220,Pr-Atalaia,202503,483,558,1156,2197,4.045,"54,31%","11,94%"
410230,Pr-Balsa Nova,202503,2027,1734,2438,6199,13.871,"44,69%","14,61%"
410240,Pr-Bandeirantes,202503,3336,4882,5575,13793,31.807,"43,36%","10,49%"
410250,Pr-Barbosa Ferraz,202503,1926,1841,1912,5679,10.692,"53,11%","18,01%"
410260,Pr-Barracao,202503,1805,1298,2048,5151,9.900,"52,03%","18,23%"
410270,Pr-Barra do Jacare,202503,538,342,658,1538,2.866,"53,66%","18,77%"
410275,Pr-Bela Vista do Caroba,202503,616,496,680,1792,4.100,"43,71%","15,02%"
410280,Pr-Bela Vista do Paraiso,202503,2182,1967,2631,6780,14.998,"45,21%","14,55%"
410290,Pr-Bituruna,202503,3372,3022,3657,10051,15.689,"64,06%","21,49%"
410300,Pr-Boa Esperanca,202503,785,547,633,1965,4.622,"42,51%","16,98%"
410302,Pr-Boa Esperanca do Iguacu,202503,217,301,298,816,2.448,"33,33%","8,86%"
410304,Pr-Boa Ventura de Sao Roque,202503,1789,1120,975,3884,6.244,"62,20%","28,65%"
410305,Pr-Boa Vista da Aparecida,202503,2059,1203,1451,4713,8.034,"58,66%","25,63%"
410310,Pr-Bocaiuva do Sul,202503,4074,2117,2148,8339,13.804,"60,41%","29,51%"
410315,Pr-Bom Jesus do Sul,202503,575,590,692,1857,4.061,"45,73%","14,16%"
410320,Pr-Bom Sucesso,202503,406,1182,1247,2835,6.677,"42,46%","6,08%"
410322,Pr-Bom Sucesso do Sul,202503,194,585,1017,1796,3.234,"55,53%","6,00%"
410330,Pr-Borrazopolis,202503,972,1207,1527,3706,7.824,"47,37%","12,42%"
410335,Pr-Braganey,202503,548,937,1012,2497,4.802,"52,00%","11,41%"
410337,Pr-Brasilandia do Sul,202503,522,651,905,2078,3.828,"54,28%","13,64%"
410340,Pr-Cafeara,202503,257,454,575,1286,2.655,"48,44%","9,68%"
410345,Pr-Cafelandia,202503,2530,2173,3746,8449,19.844,"42,58%","12,75%"
410347,Pr-Cafezal do Sul,202503,475,822,882,2179,4.561,"47,77%","10,41%"
410350,Pr-California,202503,1556,1228,1506,4290,8.921,"48,09%","17,44%"
410360,Pr-Cambara,202503,3416,3635,3835,10886,23.430,"46,46%","14,58%"
410370,Pr-Cambe,202503,11207,10822,19076,41105,111.009,"37,03%","10,10%"
410380,Pr-Cambira,202503,1076,1719,2017,4812,9.899,"48,61%","10,87%"
410390,Pr-Campina da Lagoa,202503,2859,2230,2498,7587,15.979,"47,48%","17,89%"
410395,Pr-Campina do Simao,202503,1039,925,714,2678,3.973,"67,40%","26,15%"
410400,Pr-Campina Grande do Sul,202503,8992,5511,6794,21297,49.971,"42,62%","17,99%"
410405,Pr-Campo Bonito,202503,713,662,773,2148,4.032,"53,27%","17,68%"
410410,Pr-Campo do Tenente,202503,2664,1232,990,4886,7.666,"63,74%","34,75%"
410420,Pr-Campo Largo,202503,14075,11844,13740,39659,142.695,"27,79%","9,86%"
410425,Pr-Campo Magro,202503,3657,4096,4367,12120,31.555,"38,41%","11,59%"
410430,Pr-Campo Mourao,202503,12067,10498,14158,36723,103.340,"35,54%","11,68%"
410440,Pr-Candido de Abreu,202503,3920,1909,1606,7435,15.255,"48,74%","25,70%"
410442,Pr-Candoi,202503,2094,3659,2882,8635,15.174,"56,91%","13,80%"
410445,Pr-Cantagalo,202503,1351,2881,2739,6971,10.799,"64,55%","12,51%"
410450,Pr-Capanema,202503,1985,1361,1796,5142,21.022,"24,46%","9,44%"
410460,Pr-Capitao Leonidas Marques,202503,2660,1971,3209,7840,14.796,"52,99%","17,98%"
410465,Pr-Carambei,202503,2719,3306,3375,9400,24.159,"38,91%","11,25%"
410470,Pr-Carlopolis,202503,2507,2977,2304,7788,17.567,"44,33%","14,27%"
410480,Pr-Cascavel,202503,26753,35743,51444,113940,364.104,"31,29%","7,35%"
410490,Pr-Castro,202503,13386,8907,12070,34363,75.291,"45,64%","17,78%"
410500,Pr-Catanduvas,202503,878,1891,2333,5102,10.627,"48,01%","8,26%"
410510,Pr-Centenario do Sul,202503,1582,1443,1865,4890,10.936,"44,71%","14,47%"
410520,Pr-Cerro Azul,202503,5586,2965,1762,10313,16.240,"63,50%","34,40%"
410530,Pr-Ceu Azul,202503,405,973,2441,3819,11.251,"33,94%","3,60%"
410540,Pr-Chopinzinho,202503,2721,1953,2646,7320,21.559,"33,95%","12,62%"
410550,Pr-Cianorte,202503,5467,7782,8567,21816,82.359,"26,49%","6,64%"
410560,Pr-Cidade Gaucha,202503,733,1536,1454,3723,11.684,"31,86%","6,27%"
410570,Pr-Clevelandia,202503,2050,3060,2940,8050,14.975,"53,76%","13,69%"
410580,Pr-Colombo,202503,32245,27092,29412,88749,240.720,"36,87%","13,40%"
410590,Pr-Colorado,202503,1078,2139,2273,5490,23.278,"23,58%","4,63%"
410600,Pr-Congonhinhas,202503,2469,1299,1392,5160,8.442,"61,12%","29,25%"
410610,Pr-Conselheiro Mairinck,202503,557,666,558,1781,3.486,"51,09%","15,98%"
410620,Pr-Contenda,202503,3702,2453,2666,8821,19.827,"44,49%","18,67%"
410630,Pr-Corbelia,202503,789,2970,3084,6843,17.862,"38,31%","4,42%"
410640,Pr-Cornelio Procopio,202503,3696,4512,4156,12364,45.830,"26,98%","8,06%"
410645,Pr-Coronel Domingos Soares,202503,1978,920,902,3800,5.516,"68,89%","35,86%"
410650,Pr-Coronel Vivida,202503,2187,2229,3455,7871,23.859,"32,99%","9,17%"
410655,Pr-Corumbatai do Sul,202503,679,629,985,2293,3.780,"60,66%","17,96%"
410657,Pr-Cruzeiro do Iguacu,202503,527,519,603,1649,4.171,"39,53%","12,63%"
410660,Pr-Cruzeiro do Oeste,202503,2235,2771,4445,9451,24.622,"38,38%","9,08%"
410670,Pr-Cruzeiro do Sul,202503,592,686,1341,2619,4.547,"57,60%","13,02%"
410680,Pr-Cruz Machado,202503,3362,2439,2522,8323,15.910,"52,31%","21,13%"
410685,Pr-Cruzmaltina,202503,496,529,504,1529,2.896,"52,80%","17,13%"
410690,Pr-Curitiba,202503,125537,122855,152633,401025,1.829.225,"21,92%","6,86%"
410700,Pr-Curiuva,202503,2940,1935,1849,6724,13.802,"48,72%","21,30%"
410710,Pr-Diamante do Norte,202503,797,537,983,2317,5.164,"44,87%","15,43%"
410712,Pr-Diamante do Sul,202503,951,551,1231,2733,3.170,"86,21%","30,00%"
410715,Pr-Diamante D Oeste,202503,887,758,1145,2790,4.557,"61,22%","19,46%"
410720,Pr-Dois Vizinhos,202503,2714,4369,3960,11043,47.014,"23,49%","5,77%"
410725,Pr-Douradina,202503,772,927,1381,3080,9.525,"32,34%","8,10%"
410730,Pr-Doutor Camargo,202503,483,1004,1352,2839,6.484,"43,78%","7,45%"
410740,Pr-Eneas Marques,202503,1059,507,625,2191,6.070,"36,10%","17,45%"
410750,Pr-Engenheiro Beltrao,202503,1717,1604,1760,5081,12.431,"40,87%","13,81%"
410752,Pr-Esperanca Nova,202503,224,269,547,1040,1.858,"55,97%","12,06%"
410753,Pr-Entre Rios do Oeste,202503,123,407,427,957,4.729,"20,24%","2,60%"
410754,Pr-Espigao Alto do Iguacu,202503,1762,602,833,3197,4.881,"65,50%","36,10%"
410755,Pr-Farol,202503,497,434,543,1474,3.023,"48,76%","16,44%"
410760,Pr-Faxinal,202503,3840,3283,3276,10399,16.618,"62,58%","23,11%"
410765,Pr-Fazenda Rio Grande,202503,22908,20221,19779,62908,161.506,"38,95%","14,18%"
410770,Pr-Fenix,202503,824,770,994,2588,4.512,"57,36%","18,26%"
410773,Pr-Fernandes Pinheiro,202503,1658,986,1029,3673,6.387,"57,51%","25,96%"
410775,Pr-Figueira,202503,2405,710,821,3936,8.144,"48,33%","29,53%"
410780,Pr-Florai,202503,388,491,450,1329,4.825,"27,54%","8,04%"
410785,Pr-Flor da Serra do Sul,202503,1086,453,884,2423,4.367,"55,48%","24,87%"
410790,Pr-Floresta,202503,1671,1876,1388,4935,11.226,"43,96%","14,89%"
410800,Pr-Florestopolis,202503,3272,1392,2743,7407,11.639,"63,64%","28,11%"
410810,Pr-Florida,202503,350,436,546,1332,2.704,"49,26%","12,94%"
410820,Pr-Formosa do Oeste,202503,522,909,1863,3294,7.756,"42,47%","6,73%"
410830,Pr-Foz do Iguacu,202503,50242,33150,44341,127733,295.500,"43,23%","17,00%"
410832,Pr-Francisco Alves,202503,1123,923,953,2999,8.464,"35,43%","13,27%"
410840,Pr-Francisco Beltrao,202503,4825,8680,13433,26938,101.302,"26,59%","4,76%"
410845,Pr-Foz do Jordao,202503,1499,702,800,3001,4.925,"60,93%","30,44%"
410850,Pr-General Carneiro,202503,2892,2052,1724,6668,10.861,"61,39%","26,63%"
410855,Pr-Godoy Moreira,202503,551,591,782,1924,2.970,"64,78%","18,55%"
410860,Pr-Goioere,202503,5429,2952,3777,12158,28.970,"41,97%","18,74%"
410865,Pr-Goioxim,202503,2195,1260,868,4323,6.531,"66,19%","33,61%"
410870,Pr-Grandes Rios,202503,1347,1020,941,3308,5.586,"59,22%","24,11%"
410880,Pr-Guaira,202503,2299,6211,5876,14386,32.966,"43,64%","6,97%"
410890,Pr-Guairaca,202503,1246,1149,995,3390,6.733,"50,35%","18,51%"
410895,Pr-Guamiranga,202503,1447,1182,867,3496,7.961,"43,91%","18,18%"
410900,Pr-Guapirama,202503,696,950,1063,2709,4.792,"56,53%","14,52%"
410910,Pr-Guaporema,202503,310,270,472,1052,2.217,"47,45%","13,98%"
410920,Pr-Guaraci,202503,890,628,905,2423,4.762,"50,88%","18,69%"
410930,Pr-Guaraniacu,202503,870,2235,1926,5031,13.814,"36,42%","6,30%"
410940,Pr-Guarapuava,202503,30688,21793,26124,78605,188.710,"41,65%","16,26%"
410950,Pr-Guaraquecaba,202503,3847,1148,831,5826,7.474,"77,95%","51,47%"
410960,Pr-Guaratuba,202503,9963,7694,7397,25054,44.323,"56,53%","22,48%"
410965,Pr-Honorio Serpa,202503,868,819,1418,3105,4.872,"63,73%","17,82%"
410970,Pr-Ibaiti,202503,2939,4668,5109,12716,29.440,"43,19%","9,98%"
410975,Pr-Ibema,202503,1074,1419,1782,4275,6.327,"67,57%","16,97%"
410980,Pr-Ibipora,202503,7422,6081,9107,22610,53.054,"42,62%","13,99%"
410990,Pr-Icaraima,202503,1820,1023,1302,4145,9.139,"45,36%","19,91%"
411000,Pr-Iguaracu,202503,492,721,727,1940,5.599,"34,65%","8,79%"
411005,Pr-Iguatu,202503,371,389,679,1439,2.162,"66,56%","17,16%"
411007,Pr-Imbau,202503,2256,2365,2416,7037,14.815,"47,50%","15,23%"
411010,Pr-Imbituva,202503,3833,5552,6205,15590,30.757,"50,69%","12,46%"
411020,Pr-Inacio Martins,202503,3083,2112,1779,6974,9.633,"72,40%","32,00%"
411030,Pr-Inaja,202503,532,542,846,1920,2.510,"76,49%","21,20%"
411040,Pr-Indianopolis,202503,507,619,1318,2444,4.531,"53,94%","11,19%"
411050,Pr-Ipiranga,202503,1441,3363,2088,6892,14.338,"48,07%","10,05%"
411060,Pr-Ipora,202503,1543,2272,2979,6794,16.062,"42,30%","9,61%"
411065,Pr-Iracema do Oeste,202503,213,378,599,1190,2.344,"50,77%","9,09%"
411070,Pr-Irati,202503,8348,6368,6809,21525,60.796,"35,41%","13,73%"
411080,Pr-Iretama,202503,1897,1859,2295,6051,10.843,"55,81%","17,50%"
411090,Pr-Itaguaje,202503,487,756,1107,2350,4.532,"51,85%","10,75%"
411095,Pr-Itaipulandia,202503,877,2088,3189,6154,11.984,"51,35%","7,32%"
411100,Pr-Itambaraca,202503,1056,960,1208,3224,5.874,"54,89%","17,98%"
411110,Pr-Itambe,202503,119,678,1088,1885,6.215,"30,33%","1,91%"
411120,Pr-Itapejara D Oeste,202503,1427,1705,2139,5271,12.766,"41,29%","11,18%"
411125,Pr-Itaperucu,202503,8418,4861,4316,17595,32.890,"53,50%","25,59%"
411130,Pr-Itauna do Sul,202503,543,633,970,2146,3.620,"59,28%","15,00%"
411140,Pr-Ivai,202503,2743,2389,2161,7293,13.473,"54,13%","20,36%"
411150,Pr-Ivaipora,202503,1719,4679,5172,11570,33.529,"34,51%","5,13%"
411155,Pr-Ivate,202503,1026,775,1143,2944,6.833,"43,09%","15,02%"
411160,Pr-Ivatuba,202503,229,351,458,1038,2.705,"38,37%","8,47%"
411170,Pr-Jaboti,202503,1216,694,846,2756,5.576,"49,43%","21,81%"
411180,Pr-Jacarezinho,202503,6792,4291,3766,14849,41.400,"35,87%","16,41%"
411190,Pr-Jaguapita,202503,1937,1890,2206,6033,15.719,"38,38%","12,32%"
411200,Pr-Jaguariaiva,202503,5194,4929,4091,14214,36.231,"39,23%","14,34%"
411210,Pr-Jandaia do Sul,202503,2462,2386,3617,8465,21.851,"38,74%","11,27%"
411220,Pr-Janiopolis,202503,919,688,1034,2641,5.835,"45,26%","15,75%"
411230,Pr-Japira,202503,567,942,759,2268,5.060,"44,82%","11,21%"
411240,Pr-Japura,202503,1071,1156,1515,3742,9.354,"40,00%","11,45%"
411250,Pr-Jardim Alegre,202503,1890,2090,2411,6391,12.130,"52,69%","15,58%"
411260,Pr-Jardim Olinda,202503,235,284,432,951,1.353,"70,29%","17,37%"
411270,Pr-Jataizinho,202503,2315,1681,2018,6014,11.971,"50,24%","19,34%"
411275,Pr-Jesuitas,202503,1392,1068,1647,4107,10.860,"37,82%","12,82%"
411280,Pr-Joaquim Tavora,202503,1419,1443,1621,4483,12.280,"36,51%","11,56%"
411290,Pr-Jundiai do Sul,202503,741,678,932,2351,3.366,"69,85%","22,01%"
411295,Pr-Juranda,202503,1106,1180,1178,3464,7.898,"43,86%","14,00%"
411300,Pr-Jussara,202503,644,780,1150,2574,6.795,"37,88%","9,48%"
411310,Pr-Kalore,202503,895,562,906,2363,4.657,"50,74%","19,22%"
411320,Pr-Lapa,202503,5747,4752,5725,16224,45.857,"35,38%","12,53%"
411325,Pr-Laranjal,202503,2570,981,1082,4633,5.575,"83,10%","46,10%"
411330,Pr-Laranjeiras do Sul,202503,3149,3455,2499,9103,33.103,"27,50%","9,51%"
411340,Pr-Leopolis,202503,627,648,1055,2330,3.751,"62,12%","16,72%"
411342,Pr-Lidianopolis,202503,723,717,1467,2907,3.989,"72,88%","18,12%"
411345,Pr-Lindoeste,202503,1509,751,1104,3364,5.226,"64,37%","28,87%"
411350,Pr-Loanda,202503,1511,3494,3903,8908,23.813,"37,41%","6,35%"
411360,Pr-Lobato,202503,591,607,780,1978,4.693,"42,15%","12,59%"
411370,Pr-Londrina,202503,63816,43011,57371,164198,577.318,"28,44%","11,05%"
411373,Pr-Luiziana,202503,1645,1040,1026,3711,6.696,"55,42%","24,57%"
411375,Pr-Lunardelli,202503,719,910,1251,2880,4.902,"58,75%","14,67%"
411380,Pr-Lupionopolis,202503,998,561,1469,3028,4.911,"61,66%","20,32%"
411390,Pr-Mallet,202503,1596,1186,1337,4119,13.655,"30,16%","11,69%"
411400,Pr-Mambore,202503,2239,1790,2094,6123,13.572,"45,11%","16,50%"
411410,Pr-Mandaguacu,202503,2679,3412,3936,10027,33.752,"29,71%","7,94%"
411420,Pr-Mandaguari,202503,1247,3558,6092,10897,38.050,"28,64%","3,28%"
411430,Pr-Mandirituba,202503,4162,4216,3884,12262,28.761,"42,63%","14,47%"
411435,Pr-Manfrinopolis,202503,205,417,672,1294,2.761,"46,87%","7,42%"
411440,Pr-Mangueirinha,202503,2381,3092,2847,8320,16.764,"49,63%","14,20%"
411450,Pr-Manoel Ribas,202503,3036,1918,2109,7063,14.576,"48,46%","20,83%"
411460,Pr-Marechal Candido Rondon,202503,2715,4179,5891,12785,58.140,"21,99%","4,67%"
411470,Pr-Maria Helena,202503,1344,573,791,2708,5.935,"45,63%","22,65%"
411480,Pr-Marialva,202503,3810,5819,7332,16961,44.098,"38,46%","8,64%"
411490,Pr-Marilandia do Sul,202503,1763,1398,1405,4566,8.774,"52,04%","20,09%"
411500,Pr-Marilena,202503,1032,1111,1557,3700,7.409,"49,94%","13,93%"
411510,Pr-Mariluz,202503,1857,2196,2073,6126,9.934,"61,67%","18,69%"
411520,Pr-Maringa,202503,29369,25535,55688,110592,425.983,"25,96%","6,89%"
411530,Pr-Mariopolis,202503,626,862,1124,2612,6.475,"40,34%","9,67%"
411535,Pr-Maripa,202503,201,779,828,1808,6.767,"26,72%","2,97%"
411540,Pr-Marmeleiro,202503,2617,1729,2615,6961,16.386,"42,48%","15,97%"
411545,Pr-Marquinho,202503,1449,752,508,2709,4.521,"59,92%","32,05%"
411550,Pr-Marumbi,202503,730,588,585,1903,4.778,"39,83%","15,28%"
411560,Pr-Matelandia,202503,595,1994,2805,5394,19.022,"28,36%","3,13%"
411570,Pr-Matinhos,202503,7188,5782,6174,19144,41.416,"46,22%","17,36%"
411573,Pr-Mato Rico,202503,1068,626,567,2261,3.237,"69,85%","32,99%"
411575,Pr-Maua da Serra,202503,2057,1882,1809,5748,9.628,"59,70%","21,36%"
411580,Pr-Medianeira,202503,1932,4659,5135,11726,57.120,"20,53%","3,38%"
411585,Pr-Mercedes,202503,105,620,919,1644,6.136,"26,79%","1,71%"
411590,Pr-Mirador,202503,374,407,560,1341,2.258,"59,39%","16,56%"
411600,Pr-Miraselva,202503,182,265,452,899,2.008,"44,77%","9,06%"
411605,Pr-Missal,202503,1491,933,1422,3846,11.301,"34,03%","13,19%"
411610,Pr-Moreira Sales,202503,2971,1272,2498,6741,11.137,"60,53%","26,68%"
411620,Pr-Morretes,202503,3624,2546,2029,8199,18.908,"43,36%","19,17%"
411630,Pr-Munhoz de Melo,202503,732,717,1094,2543,4.045,"62,87%","18,10%"
411640,Pr-Nossa Senhora das Gracas,202503,203,433,768,1404,3.685,"38,10%","5,51%"
411650,Pr-Nova Alianca do Ivai,202503,134,205,232,571,1.327,"43,03%","10,10%"
411660,Pr-Nova America da Colina,202503,741,665,883,2289,3.299,"69,38%","22,46%"
411670,Pr-Nova Aurora,202503,1345,985,1576,3906,14.219,"27,47%","9,46%"
411680,Pr-Nova Cantu,202503,1363,1180,1371,3914,6.799,"57,57%","20,05%"
411690,Pr-Nova Esperanca,202503,3595,3243,3957,10795,27.142,"39,77%","13,25%"
411695,Pr-Nova Esperanca do Sudoeste,202503,612,585,871,2068,5.744,"36,00%","10,65%"
411700,Pr-Nova Fatima,202503,1165,1453,1981,4599,7.201,"63,87%","16,18%"
411705,Pr-Nova Laranjeiras,202503,4520,1530,1562,7612,12.287,"61,95%","36,79%"
411710,Pr-Nova Londrina,202503,1893,1654,2306,5853,13.085,"44,73%","14,47%"
411720,Pr-Nova Olimpia,202503,575,870,1046,2491,5.960,"41,80%","9,65%"
411721,Pr-Nova Santa Barbara,202503,847,971,908,2726,4.280,"63,69%","19,79%"
411722,Pr-Nova Santa Rosa,202503,604,1080,1938,3622,8.535,"42,44%","7,08%"
411725,Pr-Nova Prata do Iguacu,202503,1099,1390,1717,4206,13.196,"31,87%","8,33%"
411727,Pr-Nova Tebas,202503,889,1905,1746,4540,6.870,"66,08%","12,94%"
411729,Pr-Novo Itacolomi,202503,492,481,891,1864,3.210,"58,07%","15,33%"
411730,Pr-Ortigueira,202503,5897,5485,5485,16867,24.627,"68,49%","23,95%"
411740,Pr-Ourizona,202503,210,439,528,1177,3.206,"36,71%","6,55%"
411745,Pr-Ouro Verde do Oeste,202503,591,920,1037,2548,7.031,"36,24%","8,41%"
411750,Pr-Paicandu,202503,6402,5761,7687,19850,48.207,"41,18%","13,28%"
411760,Pr-Palmas,202503,7962,7393,7330,22685,49.891,"45,47%","15,96%"
411770,Pr-Palmeira,202503,2786,3737,3153,9676,34.806,"27,80%","8,00%"
411780,Pr-Palmital,202503,3228,3083,2036,8347,12.967,"64,37%","24,89%"
411790,Pr-Palotina,202503,2166,3003,3674,8843,36.623,"24,15%","5,91%"
411800,Pr-Paraiso do Norte,202503,934,1350,1639,3923,13.634,"28,77%","6,85%"
411810,Pr-Paranacity,202503,1290,1116,1693,4099,9.597,"42,71%","13,44%"
411820,Pr-Paranagua,202503,28387,13795,12964,55146,149.819,"36,81%","18,95%"
411830,Pr-Paranapoema,202503,313,465,569,1347,2.378,"56,64%","13,16%"
411840,Pr-Paranavai,202503,10620,10454,14666,35740,95.525,"37,41%","11,12%"
411845,Pr-Pato Bragado,202503,329,791,918,2038,5.939,"34,32%","5,54%"
411850,Pr-Pato Branco,202503,5059,9137,10492,24688,96.602,"25,56%","5,24%"
411860,Pr-Paula Freitas,202503,908,723,796,2427,5.778,"42,00%","15,71%"
411870,Pr-Paulo Frontin,202503,798,570,588,1956,6.369,"30,71%","12,53%"
411880,Pr-Peabiru,202503,2105,1744,2149,5998,13.496,"44,44%","15,60%"
411885,Pr-Perobal,202503,640,1029,1239,2908,7.496,"38,79%","8,54%"
411890,Pr-Perola,202503,1118,1904,1622,4644,12.275,"37,83%","9,11%"
411900,Pr-Perola D Oeste,202503,503,927,1409,2839,6.235,"45,53%","8,07%"
411910,Pr-Pien,202503,1289,1361,1450,4100,14.179,"28,92%","9,09%"
411915,Pr-Pinhais,202503,15683,13293,17810,46786,131.199,"35,66%","11,95%"
411920,Pr-Pinhalao,202503,1768,1120,1031,3919,6.707,"58,43%","26,36%"
411925,Pr-Pinhal de Sao Bento,202503,556,422,544,1522,2.819,"53,99%","19,72%"
411930,Pr-Pinhao,202503,8190,5452,3932,17574,30.472,"57,67%","26,88%"
411940,Pr-Pirai do Sul,202503,3617,3795,3103,10515,24.000,"43,81%","15,07%"
411950,Pr-Piraquara,202503,23242,13949,13220,50411,124.934,"40,35%","18,60%"
411960,Pr-Pitanga,202503,6503,4977,5350,16830,34.513,"48,76%","18,84%"
411965,Pr-Pitangueiras,202503,513,449,675,1637,3.121,"52,45%","16,44%"
411970,Pr-Planaltina do Parana,202503,1015,736,890,2641,4.123,"64,06%","24,62%"
411980,Pr-Planalto,202503,1666,1211,1588,4465,14.663,"30,45%","11,36%"
411990,Pr-Ponta Grossa,202503,41194,36281,41506,118981,372.562,"31,94%","11,06%"
411995,Pr-Pontal do Parana,202503,5543,4927,4303,14773,32.426,"45,56%","17,09%"
412000,Pr-Porecatu,202503,1922,1016,1848,4786,11.438,"41,84%","16,80%"
412010,Pr-Porto Amazonas,202503,514,601,1177,2292,4.099,"55,92%","12,54%"
412015,Pr-Porto Barreiro,202503,682,467,381,1530,3.078,"49,71%","22,16%"
412020,Pr-Porto Rico,202503,436,519,599,1554,3.316,"46,86%","13,15%"
412030,Pr-Porto Vitoria,202503,814,583,607,2004,3.549,"56,47%","22,94%"
412033,Pr-Prado Ferreira,202503,603,773,991,2367,3.799,"62,31%","15,87%"
412035,Pr-Pranchita,202503,598,646,730,1974,5.833,"33,84%","10,25%"
412040,Pr-Presidente Castelo Branco,202503,547,556,1033,2136,4.336,"49,26%","12,62%"
412050,Pr-Primeiro de Maio,202503,1072,1440,1542,4054,10.121,"40,06%","10,59%"
412060,Pr-Prudentopolis,202503,7218,7945,6186,21349,50.428,"42,34%","14,31%"
412065,Pr-Quarto Centenario,202503,548,494,751,1793,4.170,"43,00%","13,14%"
412070,Pr-Quatigua,202503,1231,1191,1225,3647,8.357,"43,64%","14,73%"
412080,Pr-Quatro Barras,202503,3139,2184,2801,8124,25.109,"32,35%","12,50%"
412085,Pr-Quatro Pontes,202503,118,250,533,901,4.636,"19,43%","2,55%"
412090,Pr-Quedas do Iguacu,202503,7316,4565,5898,17779,31.405,"56,61%","23,30%"
412100,Pr-Querencia do Norte,202503,1711,2190,2106,6007,10.693,"56,18%","16,00%"
412110,Pr-Quinta do Sol,202503,599,913,1265,2777,5.060,"54,88%","11,84%"
412120,Pr-Quitandinha,202503,2460,2923,2056,7439,18.823,"39,52%","13,07%"
412125,Pr-Ramilandia,202503,528,810,1289,2627,4.293,"61,19%","12,30%"
412130,Pr-Rancho Alegre,202503,621,619,958,2198,3.501,"62,78%","17,74%"
412135,Pr-Rancho Alegre D Oeste,202503,403,351,647,1401,2.638,"53,11%","15,28%"
412140,Pr-Realeza,202503,1209,2292,2388,5889,19.903,"29,59%","6,07%"
412150,Pr-Reboucas,202503,4024,1876,2166,8066,14.754,"54,67%","27,27%"
412160,Pr-Renascenca,202503,168,1078,2185,3431,6.946,"49,40%","2,42%"
412170,Pr-Reserva,202503,6760,4058,3413,14231,24.851,"57,27%","27,20%"
412175,Pr-Reserva do Iguacu,202503,1487,1648,1406,4541,6.543,"69,40%","22,73%"
412180,Pr-Ribeirao Claro,202503,1452,1771,1754,4977,12.770,"38,97%","11,37%"
412190,Pr-Ribeirao do Pinhal,202503,2552,2806,3130,8488,13.180,"64,40%","19,36%"
412200,Pr-Rio Azul,202503,1187,2413,2543,6143,14.214,"43,22%","8,35%"
412210,Pr-Rio Bom,202503,565,463,752,1780,3.223,"55,23%","17,53%"
412215,Pr-Rio Bonito do Iguacu,202503,4126,2471,3459,10056,14.234,"70,65%","28,99%"
412217,Pr-Rio Branco do Ivai,202503,1563,558,733,2854,3.850,"74,13%","40,60%"
412220,Pr-Rio Branco do Sul,202503,5539,7511,6583,19633,39.307,"49,95%","14,09%"
412230,Pr-Rio Negro,202503,2383,3145,3171,8699,31.992,"27,19%","7,45%"
412240,Pr-Rolandia,202503,6211,7608,10423,24242,74.935,"32,35%","8,29%"
412250,Pr-Roncador,202503,1177,2109,1798,5084,11.371,"44,71%","10,35%"
412260,Pr-Rondon,202503,1097,967,1672,3736,9.240,"40,43%","11,87%"
412265,Pr-Rosario do Ivai,202503,1421,797,992,3210,5.491,"58,46%","25,88%"
412270,Pr-Sabaudia,202503,1049,963,1312,3324,9.320,"35,67%","11,26%"
412280,Pr-Salgado Filho,202503,293,522,499,1314,4.097,"32,07%","7,15%"
412290,Pr-Salto do Itarare,202503,1204,908,859,2971,5.267,"56,41%","22,86%"
412300,Pr-Salto do Lontra,202503,1828,1630,1658,5116,15.636,"32,72%","11,69%"
412310,Pr-Santa Amelia,202503,420,766,732,1918,3.386,"56,65%","12,40%"
412320,Pr-Santa Cecilia do Pavao,202503,552,651,794,1997,3.375,"59,17%","16,36%"
412330,Pr-Santa Cruz de Monte Castelo,202503,1446,1394,1728,4568,8.806,"51,87%","16,42%"
412340,Pr-Santa Fe,202503,495,1790,1904,4189,11.669,"35,90%","4,24%"
412350,Pr-Santa Helena,202503,2279,2934,4045,9258,26.341,"35,15%","8,65%"
412360,Pr-Santa Ines,202503,350,165,287,802,1.760,"45,57%","19,89%"
412370,Pr-Santa Isabel do Ivai,202503,793,1361,2045,4199,9.059,"46,35%","8,75%"
412380,Pr-Santa Izabel do Oeste,202503,709,1875,1570,4154,14.385,"28,88%","4,93%"
412382,Pr-Santa Lucia,202503,473,396,482,1351,3.657,"36,94%","12,93%"
412385,Pr-Santa Maria do Oeste,202503,2932,1918,1630,6480,9.985,"64,90%","29,36%"
412390,Pr-Santa Mariana,202503,2035,2285,2546,6866,11.034,"62,23%","18,44%"
412395,Pr-Santa Monica,202503,705,631,743,2079,3.373,"61,64%","20,90%"
412400,Pr-Santana do Itarare,202503,834,962,965,2761,5.628,"49,06%","14,82%"
412402,Pr-Santa Tereza do Oeste,202503,2122,2079,2454,6655,13.749,"48,40%","15,43%"
412405,Pr-Santa Terezinha de Itaipu,202503,2969,3244,4008,10221,25.055,"40,79%","11,85%"
412410,Pr-Santo Antonio da Platina,202503,6450,6615,6724,19789,45.534,"43,46%","14,17%"
412420,Pr-Santo Antonio do Caiua,202503,300,402,699,1401,2.496,"56,13%","12,02%"
412430,Pr-Santo Antonio do Paraiso,202503,299,315,542,1156,2.116,"54,63%","14,13%"
412440,Pr-Santo Antonio do Sudoeste,202503,2591,2972,2774,8337,24.644,"33,83%","10,51%"
412450,Pr-Santo Inacio,202503,189,692,743,1624,6.397,"25,39%","2,95%"
412460,Pr-Sao Carlos do Ivai,202503,1090,929,1145,3164,6.712,"47,14%","16,24%"
412470,Pr-Sao Jeronimo da Serra,202503,2484,1960,1247,5691,10.913,"52,15%","22,76%"
412480,Pr-Sao Joao,202503,815,1410,1922,4147,12.230,"33,91%","6,66%"
412490,Pr-Sao Joao do Caiua,202503,1325,1004,1159,3488,5.620,"62,06%","23,58%"
412500,Pr-Sao Joao do Ivai,202503,1500,1971,2133,5604,10.700,"52,37%","14,02%"
412510,Pr-Sao Joao do Triunfo,202503,1379,2633,2217,6229,13.923,"44,74%","9,90%"
412520,Pr-Sao Jorge D Oeste,202503,349,1556,1847,3752,9.550,"39,29%","3,65%"
412530,Pr-Sao Jorge do Ivai,202503,356,848,968,2172,5.193,"41,83%","6,86%"
412535,Pr-Sao Jorge do Patrocinio,202503,479,714,1344,2537,6.659,"38,10%","7,19%"
412540,Pr-Sao Jose da Boa Vista,202503,867,1132,961,2960,6.060,"48,84%","14,31%"
412545,Pr-Sao Jose das Palmeiras,202503,611,645,909,2165,4.030,"53,72%","15,16%"
412550,Pr-Sao Jose dos Pinhais,202503,37056,33200,42277,112533,345.644,"32,56%","10,72%"
412555,Pr-Sao Manoel do Parana,202503,166,224,456,846,2.173,"38,93%","7,64%"
412560,Pr-Sao Mateus do Sul,202503,2720,7899,6698,17317,43.413,"39,89%","6,27%"
412570,Pr-Sao Miguel do Iguacu,202503,3855,3653,5434,12942,30.198,"42,86%","12,77%"
412575,Pr-Sao Pedro do Iguacu,202503,1322,802,853,2977,5.769,"51,60%","22,92%"
412580,Pr-Sao Pedro do Ivai,202503,1481,1075,1603,4159,8.611,"48,30%","17,20%"
412590,Pr-Sao Pedro do Parana,202503,280,330,535,1145,2.722,"42,06%","10,29%"
412600,Pr-Sao Sebastiao da Amoreira,202503,2068,1326,1251,4645,8.100,"57,35%","25,53%"
412610,Pr-Sao Tome,202503,558,723,875,2156,5.290,"40,76%","10,55%"
412620,Pr-Sapopema,202503,1641,1037,1085,3763,6.784,"55,47%","24,19%"
412625,Pr-Sarandi,202503,7884,11775,14807,34466,125.785,"27,40%","6,27%"
412627,Pr-Saudade do Iguacu,202503,804,1144,1110,3058,6.342,"48,22%","12,68%"
412630,Pr-Senges,202503,1957,3088,3032,8077,17.344,"46,57%","11,28%"
412635,Pr-Serranopolis do Iguacu,202503,410,531,727,1668,5.138,"32,46%","7,98%"
412640,Pr-Sertaneja,202503,496,878,1553,2927,5.667,"51,65%","8,75%"
412650,Pr-Sertanopolis,202503,1601,1789,1660,5050,16.183,"31,21%","9,89%"
412660,Pr-Siqueira Campos,202503,2232,2919,3348,8499,23.712,"35,84%","9,41%"
412665,Pr-Sulina,202503,368,328,410,1106,3.495,"31,65%","10,53%"
412667,Pr-Tamarana,202503,1785,1490,1680,4955,10.645,"46,55%","16,77%"
412670,Pr-Tamboara,202503,618,757,986,2361,4.979,"47,42%","12,41%"
412680,Pr-Tapejara,202503,1539,2049,2804,6392,16.255,"39,32%","9,47%"
412690,Pr-Tapira,202503,752,947,1252,2951,5.813,"50,77%","12,94%"
412700,Pr-Teixeira Soares,202503,2143,1404,1228,4775,9.581,"49,84%","22,37%"
412710,Pr-Telemaco Borba,202503,4400,6176,4884,15460,77.182,"20,03%","5,70%"
412720,Pr-Terra Boa,202503,781,2028,1523,4332,18.048,"24,00%","4,33%"
412730,Pr-Terra Rica,202503,2753,2107,2733,7593,14.989,"50,66%","18,37%"
412740,Pr-Terra Roxa,202503,1502,2307,2651,6460,18.548,"34,83%","8,10%"
412750,Pr-Tibagi,202503,4876,3105,3663,11644,20.304,"57,35%","24,01%"
412760,Pr-Tijucas do Sul,202503,4242,2486,2436,9164,18.279,"50,13%","23,21%"
412770,Pr-Toledo,202503,7553,13303,19160,40016,158.620,"25,23%","4,76%"
412780,Pr-Tomazina,202503,1037,1159,1207,3403,8.495,"40,06%","12,21%"
412785,Pr-Tres Barras do Parana,202503,2227,1462,1856,5545,11.197,"49,52%","19,89%"
412788,Pr-Tunas do Parana,202503,1961,1298,1006,4265,6.302,"67,68%","31,12%"
412790,Pr-Tuneiras do Oeste,202503,1143,1255,1355,3753,8.095,"46,36%","14,12%"
412795,Pr-Tupassi,202503,720,968,1406,3094,8.204,"37,71%","8,78%"
412796,Pr-Turvo,202503,2376,2504,2175,7055,14.443,"48,85%","16,45%"
412800,Pr-Ubirata,202503,4374,2807,4156,11337,25.517,"44,43%","17,14%"
412810,Pr-Umuarama,202503,11555,11215,16580,39350,121.972,"32,26%","9,47%"
412820,Pr-Uniao da Vitoria,202503,5123,6498,6259,17880,56.397,"31,70%","9,08%"
412830,Pr-Uniflor,202503,309,340,418,1067,2.121,"50,31%","14,57%"
412840,Pr-Urai,202503,1932,1130,1646,4708,10.407,"45,24%","18,56%"
412850,Pr-Wenceslau Braz,202503,3820,2227,2340,8387,19.430,"43,17%","19,66%"
412853,Pr-Ventania,202503,1881,1198,1104,4183,9.779,"42,78%","19,24%"
412855,Pr-Vera Cruz do Oeste,202503,540,1340,2281,4161,8.227,"50,58%","6,56%"
412860,Pr-Vere,202503,634,669,738,2041,8.051,"25,35%","7,87%"
412862,Pr-Alto Paraiso,202503,725,532,585,1842,3.077,"59,86%","23,56%"
412863,Pr-Doutor Ulysses,202503,2099,1269,779,4147,5.773,"71,83%","36,36%"
412865,Pr-Virmond,202503,494,721,733,1948,3.842,"50,70%","12,86%"
412870,Pr-Vitorino,202503,1194,952,957,3103,10.280,"30,18%","11,61%"
412880,Pr-Xambre,202503,1064,1026,1495,3585,5.851,"61,27%","18,18%"
420005,Sc-Abdon Batista,202503,434,386,709,1529,2.633,"58,07%","16,48%"
420010,Sc-Abelardo Luz,202503,3724,2070,3572,9366,17.736,"52,81%","21,00%"
420020,Sc-Agrolandia,202503,397,656,583,1636,11.491,"14,24%","3,45%"
420030,Sc-Agronomica,202503,187,247,216,650,6.394,"10,17%","2,92%"
420040,Sc-Agua Doce,202503,162,889,1021,2072,6.625,"31,28%","2,45%"
420050,Sc-Aguas de Chapeco,202503,515,705,827,2047,6.128,"33,40%","8,40%"
420055,Sc-Aguas Frias,202503,88,230,480,798,2.963,"26,93%","2,97%"
420060,Sc-Aguas Mornas,202503,480,320,351,1151,7.082,"16,25%","6,78%"
420070,Sc-Alfredo Wagner,202503,1186,1073,871,3130,10.862,"28,82%","10,92%"
420075,Sc-Alto Bela Vista,202503,43,97,160,300,1.860,"16,13%","2,31%"
420080,Sc-Anchieta,202503,264,492,571,1327,5.984,"22,18%","4,41%"
420090,Sc-Angelina,202503,424,477,503,1404,5.472,"25,66%","7,75%"
420100,Sc-Anita Garibaldi,202503,1762,1027,1181,3970,8.367,"47,45%","21,06%"
420110,Sc-Anitapolis,202503,358,426,334,1118,3.726,"30,01%","9,61%"
420120,Sc-Antonio Carlos,202503,394,657,811,1862,12.118,"15,37%","3,25%"
420125,Sc-Apiuna,202503,347,500,594,1441,10.020,"14,38%","3,46%"
420127,Sc-Arabuta,202503,214,240,409,863,4.487,"19,23%","4,77%"
420130,Sc-Araquari,202503,5394,7011,6626,19031,50.178,"37,93%","10,75%"
420140,Sc-Ararangua,202503,5543,6035,5412,16990,75.597,"22,47%","7,33%"
420150,Sc-Armazem,202503,1039,426,514,1979,9.188,"21,54%","11,31%"
420160,Sc-Arroio Trinta,202503,100,127,365,592,3.628,"16,32%","2,76%"
420165,Sc-Arvoredo,202503,114,199,282,595,2.600,"22,88%","4,38%"
420170,Sc-Ascurra,202503,536,372,436,1344,8.635,"15,56%","6,21%"
420180,Sc-Atalanta,202503,107,189,252,548,3.270,"16,76%","3,27%"
420190,Sc-Aurora,202503,184,193,373,750,7.127,"10,52%","2,58%"
420195,Sc-Balneario Arroio da Silva,202503,3233,1914,2169,7316,17.215,"42,50%","18,78%"
420200,Sc-Balneario Camboriu,202503,6422,7935,12896,27253,148.758,"18,32%","4,32%"
420205,Sc-Balneario Barra do Sul,202503,2281,1638,2017,5936,16.360,"36,28%","13,94%"
420207,Sc-Balneario Gaivota,202503,2403,2100,2628,7131,17.306,"41,21%","13,89%"
420208,Sc-Bandeirante,202503,327,314,512,1153,3.243,"35,55%","10,08%"
420209,Sc-Barra Bonita,202503,181,163,293,637,1.662,"38,33%","10,89%"
420210,Sc-Barra Velha,202503,4715,4947,5529,15191,50.730,"29,94%","9,29%"
420213,Sc-Bela Vista do Toldo,202503,861,999,630,2490,5.950,"41,85%","14,47%"
420215,Sc-Belmonte,202503,176,342,408,926,2.709,"34,18%","6,50%"
420220,Sc-Benedito Novo,202503,309,483,523,1315,10.738,"12,25%","2,88%"
420230,Sc-Biguacu,202503,8179,5951,7061,21191,82.028,"25,83%","9,97%"
420240,Sc-Blumenau,202503,14875,16112,22524,53511,380.597,"14,06%","3,91%"
420243,Sc-Bocaina do Sul,202503,743,427,472,1642,3.618,"45,38%","20,54%"
420245,Sc-Bombinhas,202503,2600,1897,2210,6707,27.732,"24,19%","9,38%"
420250,Sc-Bom Jardim da Serra,202503,1132,478,504,2114,4.028,"52,48%","28,10%"
420253,Sc-Bom Jesus,202503,590,281,442,1313,2.872,"45,72%","20,54%"
420257,Sc-Bom Jesus do Oeste,202503,170,136,148,454,2.234,"20,32%","7,61%"
420260,Sc-Bom Retiro,202503,1404,981,1097,3482,8.468,"41,12%","16,58%"
420270,Sc-Botuvera,202503,286,395,1337,2018,5.623,"35,89%","5,09%"
420280,Sc-Braco do Norte,202503,2445,1919,2019,6383,35.534,"17,96%","6,88%"
420285,Sc-Braco do Trombudo,202503,4,136,76,216,4.203,"5,14%","0,10%"
420287,Sc-Brunopolis,202503,459,316,391,1166,2.466,"47,28%","18,61%"
420290,Sc-Brusque,202503,5965,5604,6287,17856,151.949,"11,75%","3,93%"
420300,Sc-Cacador,202503,6651,7890,14227,28768,75.998,"37,85%","8,75%"
420310,Sc-Caibi,202503,362,606,696,1664,6.431,"25,87%","5,63%"
420315,Sc-Calmon,202503,861,941,1238,3040,3.513,"86,54%","24,51%"
420320,Sc-Camboriu,202503,6440,9799,8060,24299,113.525,"21,40%","5,67%"
420325,Sc-Capao Alto,202503,252,430,378,1060,2.647,"40,05%","9,52%"
420330,Sc-Campo Alegre,202503,911,1344,1904,4159,12.815,"32,45%","7,11%"
420340,Sc-Campo Belo do Sul,202503,1373,1219,1359,3951,7.342,"53,81%","18,70%"
420350,Sc-Campo Ere,202503,2148,859,1054,4061,9.838,"41,28%","21,83%"
420360,Sc-Campos Novos,202503,956,3323,4779,9058,38.656,"23,43%","2,47%"
420370,Sc-Canelinha,202503,3187,846,966,4999,13.413,"37,27%","23,76%"
420380,Sc-Canoinhas,202503,5429,3990,5070,14489,56.721,"25,54%","9,57%"
420390,Sc-Capinzal,202503,709,1329,1407,3445,24.176,"14,25%","2,93%"
420395,Sc-Capivari de Baixo,202503,779,2004,1982,4765,24.799,"19,21%","3,14%"
420400,Sc-Catanduvas,202503,1102,1186,1402,3690,10.938,"33,74%","10,07%"
420410,Sc-Caxambu do Sul,202503,553,423,642,1618,4.732,"34,19%","11,69%"
420415,Sc-Celso Ramos,202503,463,279,422,1164,2.860,"40,70%","16,19%"
420417,Sc-Cerro Negro,202503,783,673,725,2181,3.326,"65,57%","23,54%"
420419,Sc-Chapadao do Lageado,202503,104,164,147,415,3.036,"13,67%","3,43%"
420420,Sc-Chapeco,202503,10667,19206,22424,52297,275.959,"18,95%","3,87%"
420425,Sc-Cocal do Sul,202503,511,709,868,2088,17.912,"11,66%","2,85%"
420430,Sc-Concordia,202503,2417,3846,4325,10588,85.982,"12,31%","2,81%"
420435,Sc-Cordilheira Alta,202503,391,306,474,1171,5.099,"22,97%","7,67%"
420440,Sc-Coronel Freitas,202503,1008,721,950,2679,10.583,"25,31%","9,52%"
420445,Sc-Coronel Martins,202503,140,201,269,610,2.028,"30,08%","6,90%"
420450,Sc-Corupa,202503,1051,799,1060,2910,15.781,"18,44%","6,66%"
420455,Sc-Correia Pinto,202503,2427,1722,1694,5843,16.163,"36,15%","15,02%"
420460,Sc-Criciuma,202503,11747,10151,9982,31880,225.281,"14,15%","5,21%"
420470,Sc-Cunha Pora,202503,443,607,1312,2362,11.208,"21,07%","3,95%"
420475,Sc-Cunhatai,202503,39,58,111,208,2.018,"10,31%","1,93%"
420480,Sc-Curitibanos,202503,5187,4957,6149,16293,41.512,"39,25%","12,50%"
420490,Sc-Descanso,202503,362,437,636,1435,8.660,"16,57%","4,18%"
420500,Sc-Dionisio Cerqueira,202503,1560,1184,1376,4120,15.294,"26,94%","10,20%"
420510,Sc-Dona Emma,202503,118,186,138,442,4.388,"10,07%","2,69%"
420515,Sc-Doutor Pedrinho,202503,112,203,255,570,3.719,"15,33%","3,01%"
420517,Sc-Entre Rios,202503,1226,336,481,2043,3.525,"57,96%","34,78%"
420519,Sc-Ermo,202503,353,248,310,911,2.349,"38,78%","15,03%"
420520,Sc-Erval Velho,202503,34,441,474,949,5.081,"18,68%","0,67%"
420530,Sc-Faxinal dos Guedes,202503,548,956,1158,2662,11.486,"23,18%","4,77%"
420535,Sc-Flor do Sertao,202503,93,147,493,733,1.850,"39,62%","5,03%"
420540,Sc-Florianopolis,202503,34900,39538,44835,119273,576.361,"20,69%","6,06%"
420543,Sc-Formosa do Sul,202503,212,277,352,841,2.743,"30,66%","7,73%"
420545,Sc-Forquilhinha,202503,2614,1842,2329,6785,33.929,"20,00%","7,70%"
420550,Sc-Fraiburgo,202503,3682,3934,6253,13869,34.148,"40,61%","10,78%"
420555,Sc-Frei Rogerio,202503,397,378,364,1139,2.442,"46,64%","16,26%"
420560,Sc-Galvao,202503,550,291,345,1186,3.200,"37,06%","17,19%"
420570,Sc-Garopaba,202503,4111,2764,3188,10063,32.962,"30,53%","12,47%"
420580,Sc-Garuva,202503,843,2320,2623,5786,19.554,"29,59%","4,31%"
420590,Sc-Gaspar,202503,3312,4195,5169,12676,76.982,"16,47%","4,30%"
420600,Sc-Governador Celso Ramos,202503,2406,1220,1377,5003,17.920,"27,92%","13,43%"
420610,Sc-Grao Para,202503,741,575,869,2185,6.397,"34,16%","11,58%"
420620,Sc-Gravatal,202503,733,812,926,2471,12.989,"19,02%","5,64%"
420630,Sc-Guabiruba,202503,1539,1379,1590,4508,26.082,"17,28%","5,90%"
420640,Sc-Guaraciaba,202503,236,533,972,1741,11.040,"15,77%","2,14%"
420650,Sc-Guaramirim,202503,3184,3691,4221,11096,49.941,"22,22%","6,38%"
420660,Sc-Guaruja do Sul,202503,171,432,681,1284,4.899,"26,21%","3,49%"
420665,Sc-Guatambu,202503,587,767,922,2276,9.267,"24,56%","6,33%"
420670,Sc-Herval D Oeste,202503,847,1402,1872,4121,22.173,"18,59%","3,82%"
420675,Sc-Ibiam,202503,356,182,254,792,2.055,"38,54%","17,32%"
420680,Sc-Ibicare,202503,231,200,334,765,3.304,"23,15%","6,99%"
420690,Sc-Ibirama,202503,544,1054,1351,2949,20.663,"14,27%","2,63%"
420700,Sc-Icara,202503,4827,3060,3136,11023,62.455,"17,65%","7,73%"
420710,Sc-Ilhota,202503,1846,1514,1129,4489,18.197,"24,67%","10,14%"
420720,Sc-Imarui,202503,1861,1039,1164,4064,12.127,"33,51%","15,35%"
420730,Sc-Imbituba,202503,4950,3820,3649,12419,56.107,"22,13%","8,82%"
420740,Sc-Imbuia,202503,393,345,582,1320,6.139,"21,50%","6,40%"
420750,Sc-Indaial,202503,2089,2887,3174,8150,76.333,"10,68%","2,74%"
420757,Sc-Iomere,202503,66,218,260,544,2.953,"18,42%","2,24%"
420760,Sc-Ipira,202503,195,265,680,1140,4.635,"24,60%","4,21%"
420765,Sc-Ipora do Oeste,202503,498,436,1336,2270,9.672,"23,47%","5,15%"
420768,Sc-Ipuacu,202503,2037,1276,1123,4436,8.046,"55,13%","25,32%"
420770,Sc-Ipumirim,202503,88,298,408,794,8.065,"9,85%","1,09%"
420775,Sc-Iraceminha,202503,333,254,495,1082,4.005,"27,02%","8,31%"
420780,Sc-Irani,202503,636,1070,1703,3409,10.497,"32,48%","6,06%"
420785,Sc-Irati,202503,215,225,326,766,2.100,"36,48%","10,24%"
420790,Sc-Irineopolis,202503,1598,1084,1026,3708,10.437,"35,53%","15,31%"
420800,Sc-Ita,202503,886,435,841,2162,7.310,"29,58%","12,12%"
420810,Sc-Itaiopolis,202503,1580,1830,1023,4433,22.741,"19,49%","6,95%"
420820,Sc-Itajai,202503,19842,15624,16288,51754,287.289,"18,01%","6,91%"
420830,Sc-Itapema,202503,6188,5069,6376,17633,83.330,"21,16%","7,43%"
420840,Sc-Itapiranga,202503,390,1006,1566,2962,17.149,"17,27%","2,27%"
420845,Sc-Itapoa,202503,3773,3384,3504,10661,34.546,"30,86%","10,92%"
420850,Sc-Ituporanga,202503,1261,1508,1596,4365,28.042,"15,57%","4,50%"
420860,Sc-Jabora,202503,402,378,439,1219,4.435,"27,49%","9,06%"
420870,Sc-Jacinto Machado,202503,942,770,928,2640,10.813,"24,42%","8,71%"
420880,Sc-Jaguaruna,202503,1574,1541,1307,4422,21.284,"20,78%","7,40%"
420890,Sc-Jaragua do Sul,202503,7085,8851,11649,27585,195.753,"14,09%","3,62%"
420895,Sc-Jardinopolis,202503,231,156,285,672,1.808,"37,17%","12,78%"
420900,Sc-Joacaba,202503,1186,1612,2386,5184,31.509,"16,45%","3,76%"
420910,Sc-Joinville,202503,35424,36703,39664,111791,654.888,"17,07%","5,41%"
420915,Sc-Jose Boiteux,202503,859,719,365,1943,6.307,"30,81%","13,62%"
420917,Sc-Jupia,202503,246,300,926,1472,2.675,"55,03%","9,20%"
420920,Sc-Lacerdopolis,202503,22,80,197,299,2.296,"13,02%","0,96%"
420930,Sc-Lages,202503,20904,15489,19585,55978,171.609,"32,62%","12,18%"
420940,Sc-Laguna,202503,3330,3669,4299,11298,43.992,"25,68%","7,57%"
420945,Sc-Lajeado Grande,202503,164,210,449,823,1.771,"46,47%","9,26%"
420950,Sc-Laurentino,202503,388,439,605,1432,8.427,"16,99%","4,60%"
420960,Sc-Lauro Muller,202503,806,1123,1167,3096,14.622,"21,17%","5,51%"
420970,Sc-Lebon Regis,202503,2062,2414,2800,7276,11.605,"62,70%","17,77%"
420980,Sc-Leoberto Leal,202503,200,474,235,909,3.381,"26,89%","5,92%"
420985,Sc-Lindoia do Sul,202503,185,395,589,1169,4.611,"25,35%","4,01%"
420990,Sc-Lontras,202503,232,612,528,1372,13.586,"10,10%","1,71%"
421000,Sc-Luiz Alves,202503,463,901,803,2167,12.126,"17,87%","3,82%"
421003,Sc-Luzerna,202503,65,315,768,1148,5.931,"19,36%","1,10%"
421005,Sc-Macieira,202503,90,190,136,416,1.800,"23,11%","5,00%"
421010,Sc-Mafra,202503,4787,3902,4184,12873,57.023,"22,58%","8,39%"
421020,Sc-Major Gercino,202503,566,381,485,1432,3.258,"43,95%","17,37%"
421030,Sc-Major Vieira,202503,1361,1203,1109,3673,7.545,"48,68%","18,04%"
421040,Sc-Maracaja,202503,703,656,859,2218,8.213,"27,01%","8,56%"
421050,Sc-Maravilha,202503,805,1338,2034,4177,30.155,"13,85%","2,67%"
421055,Sc-Marema,202503,171,107,195,473,2.219,"21,32%","7,71%"
421060,Sc-Massaranduba,202503,747,1001,1003,2751,17.897,"15,37%","4,17%"
421070,Sc-Matos Costa,202503,698,600,1020,2318,2.795,"82,93%","24,97%"
421080,Sc-Meleiro,202503,479,531,499,1509,7.127,"21,17%","6,72%"
421085,Sc-Mirim Doce,202503,54,276,440,770,2.554,"30,15%","2,11%"
421090,Sc-Modelo,202503,231,214,367,812,4.156,"19,54%","5,56%"
421100,Sc-Mondai,202503,130,763,1234,2127,10.216,"20,82%","1,27%"
421105,Sc-Monte Carlo,202503,1005,1853,1598,4456,9.235,"48,25%","10,88%"
421110,Sc-Monte Castelo,202503,2122,918,915,3955,7.787,"50,79%","27,25%"
421120,Sc-Morro da Fumaca,202503,946,1499,1723,4168,19.265,"21,64%","4,91%"
421125,Sc-Morro Grande,202503,294,399,529,1222,3.085,"39,61%","9,53%"
421130,Sc-Navegantes,202503,10086,9289,7544,26919,93.619,"28,75%","10,77%"
421140,Sc-Nova Erechim,202503,472,277,500,1249,5.408,"23,10%","8,73%"
421145,Sc-Nova Itaberaba,202503,307,382,418,1107,4.648,"23,82%","6,60%"
421150,Sc-Nova Trento,202503,912,866,1191,2969,14.252,"20,83%","6,40%"
421160,Sc-Nova Veneza,202503,730,676,744,2150,13.968,"15,39%","5,23%"
421165,Sc-Novo Horizonte,202503,120,235,426,781,2.670,"29,25%","4,49%"
421170,Sc-Orleans,202503,1673,1088,1078,3839,24.474,"15,69%","6,84%"
421175,Sc-Otacilio Costa,202503,1036,1071,1566,3673,17.780,"20,66%","5,83%"
421180,Sc-Ouro,202503,230,305,543,1078,7.091,"15,20%","3,24%"
421185,Sc-Ouro Verde,202503,332,268,274,874,2.203,"39,67%","15,07%"
421187,Sc-Paial,202503,128,178,337,643,1.992,"32,28%","6,43%"
421189,Sc-Painel,202503,407,451,604,1462,2.228,"65,62%","18,27%"
421190,Sc-Palhoca,202503,19700,17614,19319,56633,245.477,"23,07%","8,03%"
421200,Sc-Palma Sola,202503,1037,693,892,2622,7.709,"34,01%","13,45%"
421205,Sc-Palmeira,202503,321,233,296,850,2.640,"32,20%","12,16%"
421210,Sc-Palmitos,202503,822,945,1226,2993,15.812,"18,93%","5,20%"
421220,Sc-Papanduva,202503,1218,1992,1365,4575,19.667,"23,26%","6,19%"
421223,Sc-Paraiso,202503,416,326,546,1288,4.376,"29,43%","9,51%"
421225,Sc-Passo de Torres,202503,2001,1100,896,3997,14.284,"27,98%","14,01%"
421227,Sc-Passos Maia,202503,781,568,1006,2355,4.032,"58,41%","19,37%"
421230,Sc-Paulo Lopes,202503,904,749,727,2380,9.661,"24,64%","9,36%"
421240,Sc-Pedras Grandes,202503,176,313,514,1003,4.343,"23,09%","4,05%"
421250,Sc-Penha,202503,3213,2316,2753,8282,36.124,"22,93%","8,89%"
421260,Sc-Peritiba,202503,38,124,711,873,3.039,"28,73%","1,25%"
421265,Sc-Pescaria Brava,202503,1387,890,991,3268,10.531,"31,03%","13,17%"
421270,Sc-Petrolandia,202503,360,350,507,1217,6.942,"17,53%","5,19%"
421280,Sc-Picarras,202503,3374,2970,2996,9340,29.725,"31,42%","11,35%"
421290,Sc-Pinhalzinho,202503,355,1219,1865,3439,23.379,"14,71%","1,52%"
421300,Sc-Pinheiro Preto,202503,91,416,854,1361,3.598,"37,83%","2,53%"
421310,Sc-Piratuba,202503,223,287,366,876,6.053,"14,47%","3,68%"
421315,Sc-Planalto Alegre,202503,170,445,709,1324,3.053,"43,37%","5,57%"
421320,Sc-Pomerode,202503,109,677,1236,2022,36.392,"5,56%","0,30%"
421330,Sc-Ponte Alta,202503,376,748,968,2092,4.430,"47,22%","8,49%"
421335,Sc-Ponte Alta do Norte,202503,505,531,467,1503,3.249,"46,26%","15,54%"
421340,Sc-Ponte Serrada,202503,1513,1567,1844,4924,10.764,"45,75%","14,06%"
421350,Sc-Porto Belo,202503,1547,1876,2379,5802,30.590,"18,97%","5,06%"
421360,Sc-Porto Uniao,202503,1499,2318,2687,6504,33.727,"19,28%","4,44%"
421370,Sc-Pouso Redondo,202503,529,1164,1266,2959,17.836,"16,59%","2,97%"
421380,Sc-Praia Grande,202503,1416,659,669,2744,8.602,"31,90%","16,46%"
421390,Sc-Presidente Castelo Branco,202503,95,117,150,362,1.711,"21,16%","5,55%"
421400,Sc-Presidente Getulio,202503,560,756,1023,2339,21.293,"10,98%","2,63%"
421410,Sc-Presidente Nereu,202503,119,206,266,591,2.345,"25,20%","5,07%"
421415,Sc-Princesa,202503,160,206,263,629,3.054,"20,60%","5,24%"
421420,Sc-Quilombo,202503,648,542,861,2051,11.359,"18,06%","5,70%"
421430,Sc-Rancho Queimado,202503,51,239,268,558,3.435,"16,24%","1,48%"
421440,Sc-Rio das Antas,202503,736,737,983,2456,6.386,"38,46%","11,53%"
421450,Sc-Rio do Campo,202503,173,678,465,1316,6.613,"19,90%","2,62%"
421460,Sc-Rio do Oeste,202503,32,501,463,996,8.008,"12,44%","0,40%"
421470,Sc-Rio dos Cedros,202503,349,490,591,1430,11.163,"12,81%","3,13%"
421480,Sc-Rio do Sul,202503,3838,3814,4210,11862,76.390,"15,53%","5,02%"
421490,Sc-Rio Fortuna,202503,57,219,208,484,5.006,"9,67%","1,14%"
421500,Sc-Rio Negrinho,202503,3340,2698,3376,9414,40.168,"23,44%","8,32%"
421505,Sc-Rio Rufino,202503,460,302,241,1003,2.432,"41,24%","18,91%"
421507,Sc-Riqueza,202503,310,419,446,1175,4.835,"24,30%","6,41%"
421510,Sc-Rodeio,202503,710,525,767,2002,13.321,"15,03%","5,33%"
421520,Sc-Romelandia,202503,317,394,771,1482,4.757,"31,15%","6,66%"
421530,Sc-Salete,202503,337,398,590,1325,7.643,"17,34%","4,41%"
421535,Sc-Saltinho,202503,448,322,548,1318,3.633,"36,28%","12,33%"
421540,Sc-Salto Veloso,202503,216,318,630,1164,4.486,"25,95%","4,81%"
421545,Sc-Sangao,202503,1110,911,767,2788,13.567,"20,55%","8,18%"
421550,Sc-Santa Cecilia,202503,2686,2168,2393,7247,15.764,"45,97%","17,04%"
421555,Sc-Santa Helena,202503,47,154,523,724,2.473,"29,28%","1,90%"
421560,Sc-Santa Rosa de Lima,202503,98,208,237,543,2.128,"25,52%","4,61%"
421565,Sc-Santa Rosa do Sul,202503,1477,826,898,3201,10.288,"31,11%","14,36%"
421567,Sc-Santa Terezinha,202503,399,634,602,1635,8.077,"20,24%","4,94%"
421568,Sc-Santa Terezinha do Progresso,202503,194,292,668,1154,2.562,"45,04%","7,57%"
421569,Sc-Santiago do Sul,202503,70,60,229,359,1.714,"20,95%","4,08%"
421570,Sc-Santo Amaro da Imperatriz,202503,1532,2008,2358,5898,29.392,"20,07%","5,21%"
421575,Sc-Sao Bernardino,202503,176,448,624,1248,2.719,"45,90%","6,47%"
421580,Sc-Sao Bento do Sul,202503,4121,5326,9094,18541,86.851,"21,35%","4,74%"
421590,Sc-Sao Bonifacio,202503,308,238,210,756,2.986,"25,32%","10,31%"
421600,Sc-Sao Carlos,202503,512,566,820,1898,10.460,"18,15%","4,89%"
421605,Sc-Sao Cristovao do Sul,202503,510,775,764,2049,6.389,"32,07%","7,98%"
421610,Sc-Sao Domingos,202503,860,934,1061,2855,9.356,"30,52%","9,19%"
421620,Sc-Sao Francisco do Sul,202503,4477,4345,3876,12698,55.784,"22,76%","8,03%"
421625,Sc-Sao Joao do Oeste,202503,84,118,209,411,6.446,"6,38%","1,30%"
421630,Sc-Sao Joao Batista,202503,1814,3446,4015,9275,34.733,"26,70%","5,22%"
421635,Sc-Sao Joao do Itaperiu,202503,529,438,669,1636,4.732,"34,57%","11,18%"
421640,Sc-Sao Joao do Sul,202503,1356,581,618,2555,9.126,"28,00%","14,86%"
421650,Sc-Sao Joaquim,202503,2750,3392,3128,9270,26.852,"34,52%","10,24%"
421660,Sc-Sao Jose,202503,17342,14454,14664,46460,289.949,"16,02%","5,98%"
421670,Sc-Sao Jose do Cedro,202503,811,897,1310,3018,14.491,"20,83%","5,60%"
421680,Sc-Sao Jose do Cerrito,202503,2278,1294,1196,4768,8.755,"54,46%","26,02%"
421690,Sc-Sao Lourenco do Oeste,202503,1002,1985,2175,5162,25.770,"20,03%","3,89%"
421700,Sc-Sao Ludgero,202503,319,796,953,2068,14.211,"14,55%","2,24%"
421710,Sc-Sao Martinho,202503,147,188,333,668,3.501,"19,08%","4,20%"
421715,Sc-Sao Miguel da Boa Vista,202503,181,151,372,704,1.788,"39,37%","10,12%"
421720,Sc-Sao Miguel D Oeste,202503,1931,2266,3377,7574,46.969,"16,13%","4,11%"
421725,Sc-Sao Pedro de Alcantara,202503,211,253,458,922,6.076,"15,17%","3,47%"
421730,Sc-Saudades,202503,374,572,1229,2175,10.680,"20,37%","3,50%"
421740,Sc-Schroeder,202503,430,1064,1241,2735,21.273,"12,86%","2,02%"
421750,Sc-Seara,202503,596,932,1346,2874,19.241,"14,94%","3,10%"
421755,Sc-Serra Alta,202503,112,149,270,531,3.367,"15,77%","3,33%"
421760,Sc-Sideropolis,202503,866,1055,1610,3531,14.087,"25,07%","6,15%"
421770,Sc-Sombrio,202503,2661,2895,2574,8130,31.397,"25,89%","8,48%"
421775,Sc-Sul Brasil,202503,194,161,288,643,2.894,"22,22%","6,70%"
421780,Sc-Taio,202503,1032,1157,1149,3338,18.808,"17,75%","5,49%"
421790,Sc-Tangara,202503,518,776,1680,2974,8.189,"36,32%","6,33%"
421795,Sc-Tigrinhos,202503,166,233,521,920,2.480,"37,10%","6,69%"
421800,Sc-Tijucas,202503,3860,3876,4660,12396,56.674,"21,87%","6,81%"
421810,Sc-Timbe do Sul,202503,555,538,677,1770,5.495,"32,21%","10,10%"
421820,Sc-Timbo,202503,751,1444,2230,4425,48.903,"9,05%","1,54%"
421825,Sc-Timbo Grande,202503,2351,1154,999,4504,7.503,"60,03%","31,33%"
421830,Sc-Tres Barras,202503,2001,2751,2615,7367,20.373,"36,16%","9,82%"
421835,Sc-Treviso,202503,338,156,241,735,3.895,"18,87%","8,68%"
421840,Sc-Treze de Maio,202503,323,670,645,1638,7.585,"21,60%","4,26%"
421850,Sc-Treze Tilias,202503,312,528,596,1436,9.308,"15,43%","3,35%"
421860,Sc-Trombudo Central,202503,111,194,327,632,7.532,"8,39%","1,47%"
421870,Sc-Tubarao,202503,6617,5613,7140,19370,115.495,"16,77%","5,73%"
421875,Sc-Tunapolis,202503,86,325,849,1260,5.054,"24,93%","1,70%"
421880,Sc-Turvo,202503,506,877,906,2289,13.492,"16,97%","3,75%"
421885,Sc-Uniao do Oeste,202503,73,269,466,808,2.801,"28,85%","2,61%"
421890,Sc-Urubici,202503,1981,896,1025,3902,11.048,"35,32%","17,93%"
421895,Sc-Urupema,202503,634,363,285,1282,2.735,"46,87%","23,18%"
421900,Sc-Urussanga,202503,807,970,1572,3349,21.395,"15,65%","3,77%"
421910,Sc-Vargeao,202503,140,473,716,1329,3.716,"35,76%","3,77%"
421915,Sc-Vargem,202503,228,346,576,1150,2.632,"43,69%","8,66%"
421917,Sc-Vargem Bonita,202503,412,435,863,1710,4.615,"37,05%","8,93%"
421920,Sc-Vidal Ramos,202503,351,502,551,1404,6.275,"22,37%","5,59%"
421930,Sc-Videira,202503,2112,3631,5339,11082,58.299,"19,01%","3,62%"
421935,Sc-Vitor Meireles,202503,497,503,365,1365,5.492,"24,85%","9,05%"
421940,Sc-Witmarsum,202503,142,323,715,1180,4.451,"26,51%","3,19%"
421950,Sc-Xanxere,202503,1980,3331,4477,9788,54.194,"18,06%","3,65%"
421960,Sc-Xavantina,202503,111,117,143,371,3.627,"10,23%","3,06%"
421970,Sc-Xaxim,202503,2621,1908,4188,8717,33.902,"25,71%","7,73%"
421985,Sc-Zortea,202503,323,308,396,1027,4.170,"24,63%","7,75%"
422000,Sc-Balneario Rincao,202503,2876,1582,1756,6214,17.226,"36,07%","16,70%"
430003,Rs-Acegua,202503,843,553,860,2256,4.253,"53,04%","19,82%"
430005,Rs-Agua Santa,202503,602,267,424,1293,4.000,"32,33%","15,05%"
430010,Rs-Agudo,202503,2296,1258,1391,4945,16.346,"30,25%","14,05%"
430020,Rs-Ajuricaba,202503,582,461,518,1561,6.848,"22,79%","8,50%"
430030,Rs-Alecrim,202503,1008,694,1781,3483,6.228,"55,92%","16,18%"
430040,Rs-Alegrete,202503,8759,7996,10788,27543,74.329,"37,06%","11,78%"
430045,Rs-Alegria,202503,661,376,564,1601,3.711,"43,14%","17,81%"
430047,Rs-Almirante Tamandare do Sul,202503,132,96,526,754,2.008,"37,55%","6,57%"
430050,Rs-Alpestre,202503,536,772,1096,2404,7.243,"33,19%","7,40%"
430055,Rs-Alto Alegre,202503,135,143,408,686,1.837,"37,34%","7,35%"
430057,Rs-Alto Feliz,202503,34,85,196,315,3.143,"10,02%","1,08%"
430060,Rs-Alvorada,202503,33867,21543,21520,76930,194.116,"39,63%","17,45%"
430063,Rs-Amaral Ferrador,202503,1304,480,426,2210,5.394,"40,97%","24,18%"
430064,Rs-Ametista do Sul,202503,1515,1012,1092,3619,7.822,"46,27%","19,37%"
430066,Rs-Andre da Rocha,202503,41,124,371,536,1.157,"46,33%","3,54%"
430070,Rs-Anta Gorda,202503,267,260,1304,1831,6.080,"30,12%","4,39%"
430080,Rs-Antonio Prado,202503,553,686,1359,2598,13.328,"19,49%","4,15%"
430085,Rs-Arambare,202503,944,626,1054,2624,4.211,"62,31%","22,42%"
430087,Rs-Ararica,202503,1008,963,1072,3043,8.794,"34,60%","11,46%"
430090,Rs-Aratiba,202503,240,396,804,1440,6.618,"21,76%","3,63%"
430100,Rs-Arroio do Meio,202503,1215,1168,4428,6811,22.490,"30,28%","5,40%"
430105,Rs-Arroio do Sal,202503,2269,1370,1796,5435,11.384,"47,74%","19,93%"
430107,Rs-Arroio do Padre,202503,102,175,338,615,2.651,"23,20%","3,85%"
430110,Rs-Arroio dos Ratos,202503,3637,1201,2118,6956,14.923,"46,61%","24,37%"
430120,Rs-Arroio do Tigre,202503,1237,1122,1619,3978,12.296,"32,35%","10,06%"
430130,Rs-Arroio Grande,202503,3898,2492,2824,9214,17.887,"51,51%","21,79%"
430140,Rs-Arvorezinha,202503,1170,957,1161,3288,10.545,"31,18%","11,10%"
430150,Rs-Augusto Pestana,202503,429,586,910,1925,7.302,"26,36%","5,88%"
430155,Rs-Aurea,202503,265,114,362,741,3.460,"21,42%","7,66%"
430160,Rs-Bage,202503,29810,12242,15779,57831,121.900,"47,44%","24,45%"
430163,Rs-Balneario Pinhal,202503,4464,1834,2743,9041,15.371,"58,82%","29,04%"
430165,Rs-Barao,202503,31,229,815,1075,6.489,"16,57%","0,48%"
430170,Rs-Barao de Cotegipe,202503,328,711,1663,2702,7.313,"36,95%","4,49%"
430175,Rs-Barao do Triunfo,202503,1229,574,522,2325,5.983,"38,86%","20,54%"
430180,Rs-Barracao,202503,672,597,779,2048,4.920,"41,63%","13,66%"
430185,Rs-Barra do Guarita,202503,312,510,1126,1948,3.230,"60,31%","9,66%"
430187,Rs-Barra do Quarai,202503,1264,455,634,2353,4.337,"54,25%","29,14%"
430190,Rs-Barra do Ribeiro,202503,1947,1315,1216,4478,12.475,"35,90%","15,61%"
430192,Rs-Barra do Rio Azul,202503,37,94,301,432,1.724,"25,06%","2,15%"
430195,Rs-Barra Funda,202503,49,187,1244,1480,2.555,"57,93%","1,92%"
430200,Rs-Barros Cassal,202503,748,1753,1195,3696,9.442,"39,14%","7,92%"
430205,Rs-Benjamin Constant do Sul,202503,1025,223,311,1559,2.120,"73,54%","48,35%"
430210,Rs-Bento Goncalves,202503,3924,7480,13788,25192,127.775,"19,72%","3,07%"
430215,Rs-Boa Vista das Missoes,202503,317,268,518,1103,1.969,"56,02%","16,10%"
430220,Rs-Boa Vista do Burica,202503,321,445,1157,1923,7.125,"26,99%","4,51%"
430222,Rs-Boa Vista do Cadeado,202503,196,229,439,864,2.271,"38,04%","8,63%"
430223,Rs-Boa Vista do Incra,202503,401,240,254,895,2.315,"38,66%","17,32%"
430225,Rs-Boa Vista do Sul,202503,54,27,44,125,2.815,"4,44%","1,92%"
430230,Rs-Bom Jesus,202503,3585,1516,1739,6840,11.431,"59,84%","31,36%"
430235,Rs-Bom Principio,202503,308,621,909,1838,13.650,"13,47%","2,26%"
430237,Rs-Bom Progresso,202503,529,334,610,1473,2.134,"69,03%","24,79%"
430240,Rs-Bom Retiro do Sul,202503,936,993,2381,4310,12.578,"34,27%","7,44%"
430245,Rs-Boqueirao do Leao,202503,1153,539,619,2311,6.215,"37,18%","18,55%"
430250,Rs-Bossoroca,202503,1040,878,1075,2993,5.988,"49,98%","17,37%"
430258,Rs-Bozano,202503,132,133,170,435,2.195,"19,82%","6,01%"
430260,Rs-Braga,202503,814,454,804,2072,3.326,"62,30%","24,47%"
430265,Rs-Brochier,202503,272,326,247,845,5.079,"16,64%","5,36%"
430270,Rs-Butia,202503,4403,1856,2477,8736,19.433,"44,95%","22,66%"
430280,Rs-Cacapava do Sul,202503,5763,3102,4614,13479,33.508,"40,23%","17,20%"
430290,Rs-Cacequi,202503,3355,1030,1268,5653,11.324,"49,92%","29,63%"
430300,Rs-Cachoeira do Sul,202503,13680,7520,9867,31067,82.250,"37,77%","16,63%"
430310,Rs-Cachoeirinha,202503,18560,12081,20724,51365,141.303,"36,35%","13,13%"
430320,Rs-Cacique Doble,202503,786,647,1035,2468,4.694,"52,58%","16,74%"
430330,Rs-Caibate,202503,476,410,1057,1943,4.797,"40,50%","9,92%"
430340,Rs-Caicara,202503,935,292,666,1893,4.933,"38,37%","18,95%"
430350,Rs-Camaqua,202503,10546,6290,7318,24154,63.959,"37,76%","16,49%"
430355,Rs-Camargo,202503,169,243,959,1371,3.056,"44,86%","5,53%"
430360,Rs-Cambara do Sul,202503,735,764,1165,2664,6.492,"41,04%","11,32%"
430367,Rs-Campestre da Serra,202503,402,149,350,901,3.311,"27,21%","12,14%"
430370,Rs-Campina das Missoes,202503,218,303,1048,1569,6.001,"26,15%","3,63%"
430380,Rs-Campinas do Sul,202503,500,451,1157,2108,5.390,"39,11%","9,28%"
430390,Rs-Campo Bom,202503,1745,4959,6838,13542,64.704,"20,93%","2,70%"
430400,Rs-Campo Novo,202503,950,610,918,2478,5.068,"48,90%","18,75%"
430410,Rs-Campos Borges,202503,817,324,517,1658,3.693,"44,90%","22,12%"
430420,Rs-Candelaria,202503,4280,2449,3257,9986,29.783,"33,53%","14,37%"
430430,Rs-Candido Godoi,202503,137,364,739,1240,6.421,"19,31%","2,13%"
430435,Rs-Candiota,202503,2181,1469,2147,5797,10.992,"52,74%","19,84%"
430440,Rs-Canela,202503,6691,4187,5362,16240,50.613,"32,09%","13,22%"
430450,Rs-Cangucu,202503,10281,5425,6126,21832,50.998,"42,81%","20,16%"
430460,Rs-Canoas,202503,57474,35193,70214,162881,359.554,"45,30%","15,98%"
430461,Rs-Canudos do Vale,202503,123,92,437,652,1.687,"38,65%","7,29%"
430462,Rs-Capao Bonito do Sul,202503,243,248,470,961,1.769,"54,32%","13,74%"
430463,Rs-Capao da Canoa,202503,9069,8010,8994,26073,66.012,"39,50%","13,74%"
430465,Rs-Capao do Cipo,202503,700,274,622,1596,3.186,"50,09%","21,97%"
430466,Rs-Capao do Leao,202503,7356,3267,4251,14874,27.389,"54,31%","26,86%"
430467,Rs-Capivari do Sul,202503,556,379,549,1484,4.079,"36,38%","13,63%"
430468,Rs-Capela de Santana,202503,2287,970,1388,4645,11.416,"40,69%","20,03%"
430469,Rs-Capitao,202503,142,207,1630,1979,2.991,"66,17%","4,75%"
430470,Rs-Carazinho,202503,4333,6428,7590,18351,63.638,"28,84%","6,81%"
430471,Rs-Caraa,202503,1247,635,670,2552,7.553,"33,79%","16,51%"
430480,Rs-Carlos Barbosa,202503,440,750,1050,2240,31.528,"7,10%","1,40%"
430485,Rs-Carlos Gomes,202503,119,150,328,597,1.387,"43,04%","8,58%"
430490,Rs-Casca,202503,389,454,1017,1860,9.689,"19,20%","4,01%"
430495,Rs-Caseiros,202503,496,316,531,1343,3.064,"43,83%","16,19%"
430500,Rs-Catuipe,202503,1017,930,1053,3000,8.840,"33,94%","11,50%"
430510,Rs-Caxias do Sul,202503,27482,27747,29109,84338,479.256,"17,60%","5,73%"
430511,Rs-Centenario,202503,119,260,670,1049,2.779,"37,75%","4,28%"
430512,Rs-Cerrito,202503,1082,843,746,2671,5.915,"45,16%","18,29%"
430513,Rs-Cerro Branco,202503,652,374,1242,2268,3.865,"58,68%","16,87%"
430515,Rs-Cerro Grande,202503,459,294,596,1349,2.429,"55,54%","18,90%"
430517,Rs-Cerro Grande do Sul,202503,2031,1102,1365,4498,9.343,"48,14%","21,74%"
430520,Rs-Cerro Largo,202503,647,1106,2025,3778,14.009,"26,97%","4,62%"
430530,Rs-Chapada,202503,533,739,2288,3560,9.748,"36,52%","5,47%"
430535,Rs-Charqueadas,202503,4231,2933,4528,11692,36.109,"32,38%","11,72%"
430537,Rs-Charrua,202503,884,304,346,1534,2.807,"54,65%","31,49%"
430540,Rs-Chiapeta,202503,415,490,883,1788,3.992,"44,79%","10,40%"
430543,Rs-Chui,202503,890,906,961,2757,6.405,"43,04%","13,90%"
430544,Rs-Chuvisca,202503,560,722,904,2186,4.686,"46,65%","11,95%"
430545,Rs-Cidreira,202503,3578,2083,2210,7871,17.538,"44,88%","20,40%"
430550,Rs-Ciriaco,202503,390,389,636,1415,4.215,"33,57%","9,25%"
430558,Rs-Colinas,202503,106,99,332,537,2.474,"21,71%","4,28%"
430560,Rs-Colorado,202503,90,250,535,875,3.319,"26,36%","2,71%"
430570,Rs-Condor,202503,797,428,857,2082,6.539,"31,84%","12,19%"
430580,Rs-Constantina,202503,994,736,706,2436,10.623,"22,93%","9,36%"
430583,Rs-Coqueiro Baixo,202503,39,69,510,618,1.311,"47,14%","2,97%"
430585,Rs-Coqueiros do Sul,202503,125,161,387,673,2.251,"29,90%","5,55%"
430587,Rs-Coronel Barros,202503,200,172,349,721,2.892,"24,93%","6,92%"
430590,Rs-Coronel Bicaco,202503,1400,1011,1369,3780,6.230,"60,67%","22,47%"
430593,Rs-Coronel Pilar,202503,25,51,88,164,1.638,"10,01%","1,53%"
430595,Rs-Cotipora,202503,52,202,1061,1315,3.926,"33,49%","1,32%"
430597,Rs-Coxilha,202503,194,303,864,1361,2.719,"50,06%","7,13%"
430600,Rs-Crissiumal,202503,607,1625,3853,6085,13.127,"46,35%","4,62%"
430605,Rs-Cristal,202503,1665,1107,1463,4235,7.454,"56,82%","22,34%"
430607,Rs-Cristal do Sul,202503,633,370,872,1875,2.746,"68,28%","23,05%"
430610,Rs-Cruz Alta,202503,7449,4690,5443,17582,60.486,"29,07%","12,32%"
430613,Rs-Cruzaltense,202503,61,112,499,672,1.655,"40,60%","3,69%"
430620,Rs-Cruzeiro do Sul,202503,1007,958,2994,4959,12.571,"39,45%","8,01%"
430630,Rs-David Canabarro,202503,195,266,949,1410,4.403,"32,02%","4,43%"
430632,Rs-Derrubadas,202503,203,236,847,1286,2.797,"45,98%","7,26%"
430635,Rs-Dezesseis de Novembro,202503,630,283,600,1513,2.544,"59,47%","24,76%"
430637,Rs-Dilermando de Aguiar,202503,684,331,470,1485,2.859,"51,94%","23,92%"
430640,Rs-Dois Irmaos,202503,611,1194,1852,3657,31.769,"11,51%","1,92%"
430642,Rs-Dois Irmaos das Missoes,202503,296,381,865,1542,2.133,"72,29%","13,88%"
430645,Rs-Dois Lajeados,202503,94,116,249,459,3.158,"14,53%","2,98%"
430650,Rs-Dom Feliciano,202503,2768,1413,1234,5415,13.291,"40,74%","20,83%"
430655,Rs-Dom Pedro de Alcantara,202503,339,202,511,1052,2.617,"40,20%","12,95%"
430660,Rs-Dom Pedrito,202503,6807,3777,4689,15273,38.094,"40,09%","17,87%"
430670,Rs-Dona Francisca,202503,543,375,692,1610,3.136,"51,34%","17,32%"
430673,Rs-Doutor Mauricio Cardoso,202503,358,277,667,1302,4.542,"28,67%","7,88%"
430675,Rs-Doutor Ricardo,202503,79,126,747,952,1.925,"49,45%","4,10%"
430676,Rs-Eldorado do Sul,202503,11463,4998,9002,25463,40.954,"62,17%","27,99%"
430680,Rs-Encantado,202503,1379,1161,2674,5214,23.494,"22,19%","5,87%"
430690,Rs-Encruzilhada do Sul,202503,4994,2699,3102,10795,24.280,"44,46%","20,57%"
430692,Rs-Engenho Velho,202503,429,98,150,677,1.317,"51,40%","32,57%"
430693,Rs-Entre-Ijuis,202503,629,1051,1452,3132,9.364,"33,45%","6,72%"
430695,Rs-Entre Rios do Sul,202503,420,283,695,1398,2.731,"51,19%","15,38%"
430697,Rs-Erebango,202503,766,338,503,1607,3.121,"51,49%","24,54%"
430700,Rs-Erechim,202503,6229,8510,13133,27872,109.497,"25,45%","5,69%"
430705,Rs-Ernestina,202503,209,222,418,849,3.097,"27,41%","6,75%"
430710,Rs-Herval,202503,2470,542,1518,4530,6.307,"71,82%","39,16%"
430720,Rs-Erval Grande,202503,912,562,1021,2495,5.029,"49,61%","18,13%"
430730,Rs-Erval Seco,202503,930,817,1399,3146,6.902,"45,58%","13,47%"
430740,Rs-Esmeralda,202503,543,533,1162,2238,3.264,"68,57%","16,64%"
430745,Rs-Esperanca do Sul,202503,748,302,484,1534,3.294,"46,57%","22,71%"
430750,Rs-Espumoso,202503,2484,1007,1770,5261,15.478,"33,99%","16,05%"
430755,Rs-Estacao,202503,460,254,594,1308,5.688,"23,00%","8,09%"
430760,Rs-Estancia Velha,202503,3159,2554,2810,8523,49.440,"17,24%","6,39%"
430770,Rs-Esteio,202503,11503,6406,12217,30126,78.181,"38,53%","14,71%"
430780,Rs-Estrela,202503,2969,2184,4616,9769,33.243,"29,39%","8,93%"
430781,Rs-Estrela Velha,202503,751,398,845,1994,3.120,"63,91%","24,07%"
430783,Rs-Eugenio de Castro,202503,325,251,485,1061,2.685,"39,52%","12,10%"
430786,Rs-Fagundes Varela,202503,34,42,87,163,2.620,"6,22%","1,30%"
430790,Rs-Farroupilha,202503,5580,4048,6008,15636,72.477,"21,57%","7,70%"
430800,Rs-Faxinal do Soturno,202503,1173,444,723,2340,6.846,"34,18%","17,13%"
430805,Rs-Faxinalzinho,202503,507,153,390,1050,2.572,"40,82%","19,71%"
430807,Rs-Fazenda Vilanova,202503,527,520,889,1936,4.399,"44,01%","11,98%"
430810,Rs-Feliz,202503,360,685,1431,2476,13.979,"17,71%","2,58%"
430820,Rs-Flores da Cunha,202503,1040,1356,2570,4966,31.973,"15,53%","3,25%"
430825,Rs-Floriano Peixoto,202503,110,125,431,666,1.694,"39,32%","6,49%"
430830,Rs-Fontoura Xavier,202503,3091,1315,2133,6539,9.721,"67,27%","31,80%"
430840,Rs-Formigueiro,202503,1451,616,1265,3332,6.533,"51,00%","22,21%"
430843,Rs-Forquetinha,202503,58,215,697,970,2.441,"39,74%","2,38%"
430845,Rs-Fortaleza dos Valos,202503,432,360,568,1360,4.569,"29,77%","9,46%"
430850,Rs-Frederico Westphalen,202503,2517,2362,3229,8108,33.684,"24,07%","7,47%"
430860,Rs-Garibaldi,202503,768,989,2254,4011,35.522,"11,29%","2,16%"
430865,Rs-Garruchos,202503,651,326,860,1837,2.729,"67,31%","23,85%"
430870,Rs-Gaurama,202503,187,458,1028,1673,5.780,"28,94%","3,24%"
430880,Rs-General Camara,202503,1606,855,1738,4199,7.751,"54,17%","20,72%"
430885,Rs-Gentil,202503,124,147,390,661,1.783,"37,07%","6,95%"
430890,Rs-Getulio Vargas,202503,834,1153,1640,3627,16.950,"21,40%","4,92%"
430900,Rs-Girua,202503,3387,1605,3156,8148,16.282,"50,04%","20,80%"
430905,Rs-Glorinha,202503,818,877,1235,2930,7.842,"37,36%","10,43%"
430910,Rs-Gramado,202503,2685,2272,2495,7452,41.621,"17,90%","6,45%"
430912,Rs-Gramado dos Loureiros,202503,590,454,778,1822,2.049,"88,92%","28,79%"
430915,Rs-Gramado Xavier,202503,463,578,814,1855,3.356,"55,27%","13,80%"
430920,Rs-Gravatai,202503,41178,22266,27664,91108,275.294,"33,09%","14,96%"
430925,Rs-Guabiju,202503,60,59,146,265,1.442,"18,38%","4,16%"
430930,Rs-Guaiba,202503,17893,8997,15848,42738,95.956,"44,54%","18,65%"
430940,Rs-Guapore,202503,1603,1326,1673,4602,26.138,"17,61%","6,13%"
430950,Rs-Guarani das Missoes,202503,710,508,858,2076,7.553,"27,49%","9,40%"
430955,Rs-Harmonia,202503,146,211,1081,1438,5.524,"26,03%","2,64%"
430957,Rs-Herveiras,202503,426,219,128,773,2.608,"29,64%","16,33%"
430960,Rs-Horizontina,202503,1041,1081,2185,4307,19.246,"22,38%","5,41%"
430965,Rs-Hulha Negra,202503,2250,836,1353,4439,6.102,"72,75%","36,87%"
430970,Rs-Humaita,202503,329,309,753,1391,4.774,"29,14%","6,89%"
430975,Rs-Ibarama,202503,397,676,488,1561,3.793,"41,15%","10,47%"
430980,Rs-Ibiaca,202503,489,349,434,1272,4.618,"27,54%","10,59%"
430990,Rs-Ibiraiaras,202503,701,558,661,1920,6.830,"28,11%","10,26%"
430995,Rs-Ibirapuita,202503,594,364,634,1592,3.793,"41,97%","15,66%"
431000,Rs-Ibiruba,202503,526,1276,3080,4882,22.082,"22,11%","2,38%"
431010,Rs-Igrejinha,202503,3944,3294,5960,13198,34.763,"37,97%","11,35%"
431020,Rs-Ijui,202503,8188,6005,10659,24852,87.775,"28,31%","9,33%"
431030,Rs-Ilopolis,202503,194,369,509,1072,4.245,"25,25%","4,57%"
431033,Rs-Imbe,202503,4559,3705,4787,13051,27.931,"46,73%","16,32%"
431036,Rs-Imigrante,202503,83,165,564,812,3.148,"25,79%","2,64%"
431040,Rs-Independencia,202503,1174,508,1126,2808,6.558,"42,82%","17,90%"
431041,Rs-Inhacora,202503,370,276,444,1090,2.049,"53,20%","18,06%"
431043,Rs-Ipe,202503,383,289,191,863,5.496,"15,70%","6,97%"
431046,Rs-Ipiranga do Sul,202503,27,65,201,293,1.750,"16,74%","1,54%"
431050,Rs-Irai,202503,1386,990,1316,3692,7.624,"48,43%","18,18%"
431053,Rs-Itaara,202503,575,629,956,2160,5.706,"37,85%","10,08%"
431055,Rs-Itacurubi,202503,826,364,605,1795,3.042,"59,01%","27,15%"
431057,Rs-Itapuca,202503,134,262,355,751,1.967,"38,18%","6,81%"
431060,Rs-Itaqui,202503,6746,4138,5666,16550,36.830,"44,94%","18,32%"
431065,Rs-Itati,202503,542,312,565,1419,2.695,"52,65%","20,11%"
431070,Rs-Itatiba do Sul,202503,292,337,697,1326,3.249,"40,81%","8,99%"
431075,Rs-Ivora,202503,182,179,450,811,1.964,"41,29%","9,27%"
431080,Rs-Ivoti,202503,618,868,1175,2661,23.533,"11,31%","2,63%"
431085,Rs-Jaboticaba,202503,490,591,1368,2449,3.850,"63,61%","12,73%"
431087,Rs-Jacuizinho,202503,604,324,458,1386,2.070,"66,96%","29,18%"
431090,Rs-Jacutinga,202503,126,265,691,1082,3.401,"31,81%","3,70%"
431100,Rs-Jaguarao,202503,5434,2770,3463,11667,27.406,"42,57%","19,83%"
431110,Rs-Jaguari,202503,1796,805,1427,4028,10.779,"37,37%","16,66%"
431112,Rs-Jaquirana,202503,1080,402,421,1903,3.755,"50,68%","28,76%"
431113,Rs-Jari,202503,764,464,507,1735,3.414,"50,82%","22,38%"
431115,Rs-Joia,202503,1673,772,1016,3461,7.305,"47,38%","22,90%"
431120,Rs-Julio de Castilhos,202503,3075,1959,2956,7990,18.557,"43,06%","16,57%"
431123,Rs-Lagoa Bonita do Sul,202503,330,331,469,1130,2.287,"49,41%","14,43%"
431125,Rs-Lagoao,202503,1988,627,1107,3722,5.429,"68,56%","36,62%"
431127,Rs-Lagoa dos Tres Cantos,202503,87,101,618,806,1.779,"45,31%","4,89%"
431130,Rs-Lagoa Vermelha,202503,4128,2613,2988,9729,28.617,"34,00%","14,42%"
431140,Rs-Lajeado,202503,4920,5818,12920,23658,96.651,"24,48%","5,09%"
431142,Rs-Lajeado do Bugre,202503,840,384,626,1850,2.660,"69,55%","31,58%"
431150,Rs-Lavras do Sul,202503,1593,741,881,3215,7.294,"44,08%","21,84%"
431160,Rs-Liberato Salzano,202503,724,600,1216,2540,4.854,"52,33%","14,92%"
431162,Rs-Lindolfo Collor,202503,713,434,817,1964,6.409,"30,64%","11,12%"
431164,Rs-Linha Nova,202503,39,84,379,502,1.720,"29,19%","2,27%"
431170,Rs-Machadinho,202503,366,555,503,1424,5.864,"24,28%","6,24%"
431171,Rs-Macambara,202503,1590,384,580,2554,4.487,"56,92%","35,44%"
431173,Rs-Mampituba,202503,647,366,368,1381,3.201,"43,14%","20,21%"
431175,Rs-Manoel Viana,202503,1219,881,1639,3739,6.917,"54,06%","17,62%"
431177,Rs-Maquine,202503,1473,695,982,3150,7.588,"41,51%","19,41%"
431179,Rs-Marata,202503,133,122,593,848,2.521,"33,64%","5,28%"
431180,Rs-Marau,202503,2877,2420,4153,9450,46.656,"20,25%","6,17%"
431190,Rs-Marcelino Ramos,202503,229,430,1239,1898,4.389,"43,24%","5,22%"
431198,Rs-Mariana Pimentel,202503,704,414,258,1376,4.003,"34,37%","17,59%"
431200,Rs-Mariano Moro,202503,109,146,654,909,1.888,"48,15%","5,77%"
431205,Rs-Marques de Souza,202503,175,292,1102,1569,4.050,"38,74%","4,32%"
431210,Rs-Mata,202503,733,563,546,1842,4.786,"38,49%","15,32%"
431213,Rs-Mato Castelhano,202503,360,363,597,1320,2.610,"50,57%","13,79%"
431215,Rs-Mato Leitao,202503,385,412,816,1613,4.990,"32,32%","7,72%"
431217,Rs-Mato Queimado,202503,219,132,225,576,1.833,"31,42%","11,95%"
431220,Rs-Maximiliano de Almeida,202503,733,393,931,2057,4.258,"48,31%","17,21%"
431225,Rs-Minas do Leao,202503,2130,773,1331,4234,7.661,"55,27%","27,80%"
431230,Rs-Miraguai,202503,943,586,1225,2754,4.506,"61,12%","20,93%"
431235,Rs-Montauri,202503,11,70,490,571,1.530,"37,32%","0,72%"
431237,Rs-Monte Alegre dos Campos,202503,529,386,449,1364,3.250,"41,97%","16,28%"
431238,Rs-Monte Belo do Sul,202503,30,37,45,112,2.609,"4,29%","1,15%"
431240,Rs-Montenegro,202503,6342,4954,5650,16946,66.295,"25,56%","9,57%"
431242,Rs-Mormaco,202503,311,292,330,933,2.815,"33,14%","11,05%"
431244,Rs-Morrinhos do Sul,202503,206,300,804,1310,3.134,"41,80%","6,57%"
431245,Rs-Morro Redondo,202503,1274,837,1533,3644,6.169,"59,07%","20,65%"
431247,Rs-Morro Reuter,202503,175,205,467,847,6.163,"13,74%","2,84%"
431250,Rs-Mostardas,202503,2958,1311,1561,5830,12.346,"47,22%","23,96%"
431260,Rs-Mucum,202503,287,359,991,1637,4.694,"34,87%","6,11%"
431261,Rs-Muitos Capoes,202503,494,239,259,992,2.938,"33,76%","16,81%"
431262,Rs-Muliterno,202503,256,195,438,889,1.755,"50,66%","14,59%"
431265,Rs-Nao-Me-Toque,202503,715,873,3166,4754,18.314,"25,96%","3,90%"
431267,Rs-Nicolau Vergueiro,202503,230,155,302,687,1.979,"34,71%","11,62%"
431270,Rs-Nonoai,202503,2589,1598,3868,8055,14.056,"57,31%","18,42%"
431275,Rs-Nova Alvorada,202503,147,107,270,524,3.229,"16,23%","4,55%"
431280,Rs-Nova Araca,202503,105,253,523,881,5.086,"17,32%","2,06%"
431290,Rs-Nova Bassano,202503,249,462,760,1471,9.877,"14,89%","2,52%"
431295,Rs-Nova Boa Vista,202503,44,61,237,342,2.088,"16,38%","2,11%"
431300,Rs-Nova Brescia,202503,85,171,829,1085,3.105,"34,94%","2,74%"
431301,Rs-Nova Candelaria,202503,44,192,821,1057,3.134,"33,73%","1,40%"
431303,Rs-Nova Esperanca do Sul,202503,482,571,1197,2250,4.974,"45,24%","9,69%"
431306,Rs-Nova Hartz,202503,1663,1935,2500,6098,20.539,"29,69%","8,10%"
431308,Rs-Nova Padua,202503,52,47,42,141,2.390,"5,90%","2,18%"
431310,Rs-Nova Palma,202503,510,460,739,1709,5.683,"30,07%","8,97%"
431320,Rs-Nova Petropolis,202503,403,775,1173,2351,23.889,"9,84%","1,69%"
431330,Rs-Nova Prata,202503,1660,1476,3477,6613,26.587,"24,87%","6,24%"
431333,Rs-Nova Ramada,202503,143,186,297,626,2.201,"28,44%","6,50%"
431335,Rs-Nova Roma do Sul,202503,62,52,46,160,3.543,"4,52%","1,75%"
431337,Rs-Nova Santa Rita,202503,6822,2849,5149,14820,30.121,"49,20%","22,65%"
431339,Rs-Novo Cabrais,202503,532,366,625,1523,3.636,"41,89%","14,63%"
431340,Rs-Novo Hamburgo,202503,23485,16947,23880,64312,235.879,"27,26%","9,96%"
431342,Rs-Novo Machado,202503,476,211,365,1052,3.246,"32,41%","14,66%"
431344,Rs-Novo Tiradentes,202503,294,257,587,1138,2.188,"52,01%","13,44%"
431346,Rs-Novo Xingu,202503,95,136,363,594,1.678,"35,40%","5,66%"
431349,Rs-Novo Barreiro,202503,970,494,1313,2777,4.371,"63,53%","22,19%"
431350,Rs-Osorio,202503,7589,3622,4671,15882,48.929,"32,46%","15,51%"
431360,Rs-Paim Filho,202503,361,426,1021,1808,3.691,"48,98%","9,78%"
431365,Rs-Palmares do Sul,202503,3461,1292,1975,6728,13.170,"51,09%","26,28%"
431370,Rs-Palmeira das Missoes,202503,6462,3433,5087,14982,34.233,"43,76%","18,88%"
431380,Rs-Palmitinho,202503,1443,740,982,3165,8.032,"39,40%","17,97%"
431390,Rs-Panambi,202503,2291,1896,3606,7793,45.042,"17,30%","5,09%"
431395,Rs-Pantano Grande,202503,2471,1032,1483,4986,10.438,"47,77%","23,67%"
431400,Rs-Parai,202503,102,368,682,1152,7.357,"15,66%","1,39%"
431402,Rs-Paraiso do Sul,202503,1014,538,824,2376,6.635,"35,81%","15,28%"
431403,Rs-Pareci Novo,202503,219,275,335,829,4.433,"18,70%","4,94%"
431405,Rs-Parobe,202503,7979,5899,7814,21692,53.555,"40,50%","14,90%"
431406,Rs-Passa Sete,202503,612,529,734,1875,4.036,"46,46%","15,16%"
431407,Rs-Passo do Sobrado,202503,668,458,682,1808,6.154,"29,38%","10,85%"
431410,Rs-Passo Fundo,202503,25798,15554,22388,63740,214.564,"29,71%","12,02%"
431413,Rs-Paulo Bento,202503,57,153,702,912,2.188,"41,68%","2,61%"
431415,Rs-Paverama,202503,588,761,926,2275,8.146,"27,93%","7,22%"
431417,Rs-Pedras Altas,202503,550,248,600,1398,2.100,"66,57%","26,19%"
431420,Rs-Pedro Osorio,202503,1986,932,1245,4163,7.634,"54,53%","26,02%"
431430,Rs-Pejucara,202503,408,414,967,1789,3.819,"46,84%","10,68%"
431440,Rs-Pelotas,202503,55405,29275,34952,119632,336.131,"35,59%","16,48%"
431442,Rs-Picada Cafe,202503,77,206,353,636,5.470,"11,63%","1,41%"
431445,Rs-Pinhal,202503,124,269,895,1288,3.034,"42,45%","4,09%"
431446,Rs-Pinhal da Serra,202503,472,215,239,926,2.299,"40,28%","20,53%"
431447,Rs-Pinhal Grande,202503,600,547,1120,2267,3.867,"58,62%","15,52%"
431449,Rs-Pinheirinho do Vale,202503,812,623,994,2429,4.637,"52,38%","17,51%"
431450,Rs-Pinheiro Machado,202503,2741,1096,1800,5637,11.409,"49,41%","24,02%"
431454,Rs-Pinto Bandeira,202503,119,94,89,302,2.784,"10,85%","4,27%"
431455,Rs-Pirapo,202503,367,320,633,1320,2.260,"58,41%","16,24%"
431460,Rs-Piratini,202503,3809,1969,3310,9088,17.792,"51,08%","21,41%"
431470,Rs-Planalto,202503,1378,1221,1676,4275,10.624,"40,24%","12,97%"
431475,Rs-Poco das Antas,202503,21,109,544,674,2.222,"30,33%","0,95%"
431477,Rs-Pontao,202503,564,275,759,1598,3.350,"47,70%","16,84%"
431478,Rs-Ponte Preta,202503,57,146,664,867,1.604,"54,05%","3,55%"
431480,Rs-Portao,202503,2992,3703,3679,10374,35.237,"29,44%","8,49%"
431490,Rs-Porto Alegre,202503,203150,96283,148078,447511,1.389.322,"32,21%","14,62%"
431500,Rs-Porto Lucena,202503,475,378,954,1807,4.424,"40,85%","10,74%"
431505,Rs-Porto Maua,202503,279,173,245,697,2.176,"32,03%","12,82%"
431507,Rs-Porto Vera Cruz,202503,161,167,536,864,1.585,"54,51%","10,16%"
431510,Rs-Porto Xavier,202503,1742,1428,2443,5613,10.132,"55,40%","17,19%"
431513,Rs-Pouso Novo,202503,140,166,399,705,1.773,"39,76%","7,90%"
431514,Rs-Presidente Lucena,202503,124,129,109,362,3.159,"11,46%","3,93%"
431515,Rs-Progresso,202503,607,468,711,1786,5.430,"32,89%","11,18%"
431517,Rs-Protasio Alves,202503,126,91,104,321,2.069,"15,51%","6,09%"
431520,Rs-Putinga,202503,139,242,732,1113,3.814,"29,18%","3,64%"
431530,Rs-Quarai,202503,5507,3396,5784,14687,23.988,"61,23%","22,96%"
431531,Rs-Quatro Irmaos,202503,126,127,363,616,1.579,"39,01%","7,98%"
431532,Rs-Quevedos,202503,599,297,723,1619,2.555,"63,37%","23,44%"
431535,Rs-Quinze de Novembro,202503,147,262,583,992,4.000,"24,80%","3,68%"
431540,Rs-Redentora,202503,4041,1485,1393,6919,9.934,"69,65%","40,68%"
431545,Rs-Relvado,202503,98,155,819,1072,1.828,"58,64%","5,36%"
431550,Rs-Restinga Seca,202503,2236,1931,2765,6932,15.213,"45,57%","14,70%"
431555,Rs-Rio dos Indios,202503,694,354,905,1953,2.874,"67,95%","24,15%"
431560,Rs-Rio Grande,202503,28377,24509,38122,91008,198.958,"45,74%","14,26%"
431570,Rs-Rio Pardo,202503,7826,2921,4020,14767,35.666,"41,40%","21,94%"
431575,Rs-Riozinho,202503,364,417,447,1228,4.572,"26,86%","7,96%"
431580,Rs-Roca Sales,202503,822,701,2281,3804,10.644,"35,74%","7,72%"
431590,Rs-Rodeio Bonito,202503,710,852,1472,3034,6.821,"44,48%","10,41%"
431595,Rs-Rolador,202503,381,284,589,1254,2.332,"53,77%","16,34%"
431600,Rs-Rolante,202503,1818,1975,2306,6099,21.733,"28,06%","8,37%"
431610,Rs-Ronda Alta,202503,1343,1036,2165,4544,9.972,"45,57%","13,47%"
431620,Rs-Rondinha,202503,463,307,600,1370,5.083,"26,95%","9,11%"
431630,Rs-Roque Gonzales,202503,647,934,2250,3831,6.698,"57,20%","9,66%"
431640,Rs-Rosario do Sul,202503,10368,3539,4584,18491,37.700,"49,05%","27,50%"
431642,Rs-Sagrada Familia,202503,517,385,928,1830,2.529,"72,36%","20,44%"
431643,Rs-Saldanha Marinho,202503,124,242,769,1135,2.621,"43,30%","4,73%"
431645,Rs-Salto do Jacui,202503,3030,851,1536,5417,10.373,"52,22%","29,21%"
431647,Rs-Salvador das Missoes,202503,37,198,667,902,2.953,"30,55%","1,25%"
431650,Rs-Salvador do Sul,202503,151,136,292,579,7.182,"8,06%","2,10%"
431660,Rs-Sananduva,202503,343,854,1139,2336,16.759,"13,94%","2,05%"
431670,Rs-Santa Barbara do Sul,202503,1086,896,1731,3713,8.275,"44,87%","13,12%"
431673,Rs-Santa Cecilia do Sul,202503,65,194,392,651,1.710,"38,07%","3,80%"
431675,Rs-Santa Clara do Sul,202503,37,244,929,1210,7.067,"17,12%","0,52%"
431680,Rs-Santa Cruz do Sul,202503,12654,8023,12532,33209,138.104,"24,05%","9,16%"
431690,Rs-Santa Maria,202503,34052,22438,31096,87586,282.244,"31,03%","12,06%"
431695,Rs-Santa Maria do Herval,202503,131,198,418,747,6.482,"11,52%","2,02%"
431697,Rs-Santa Margarida do Sul,202503,567,322,376,1265,2.658,"47,59%","21,33%"
431700,Rs-Santana da Boa Vista,202503,1838,1026,1343,4207,7.140,"58,92%","25,74%"
431710,Rs-Santana do Livramento,202503,20918,8447,12443,41808,87.296,"47,89%","23,96%"
431720,Rs-Santa Rosa,202503,4509,6735,11136,22380,79.395,"28,19%","5,68%"
431725,Rs-Santa Tereza,202503,23,38,108,169,1.531,"11,04%","1,50%"
431730,Rs-Santa Vitoria do Palmar,202503,5336,3175,4945,13456,31.961,"42,10%","16,70%"
431740,Rs-Santiago,202503,3957,4852,5890,14699,50.331,"29,20%","7,86%"
431750,Rs-Santo Angelo,202503,7687,8937,10587,27211,79.130,"34,39%","9,71%"
431755,Rs-Santo Antonio do Palma,202503,53,179,901,1133,2.134,"53,09%","2,48%"
431760,Rs-Santo Antonio da Patrulha,202503,6064,3346,5746,15156,44.393,"34,14%","13,66%"
431770,Rs-Santo Antonio das Missoes,202503,2768,1166,1967,5901,10.493,"56,24%","26,38%"
431775,Rs-Santo Antonio do Planalto,202503,202,136,460,798,2.136,"37,36%","9,46%"
431780,Rs-Santo Augusto,202503,1693,1892,2829,6414,14.196,"45,18%","11,93%"
431790,Rs-Santo Cristo,202503,673,726,1156,2555,15.656,"16,32%","4,30%"
431795,Rs-Santo Expedito do Sul,202503,169,288,295,752,2.395,"31,40%","7,06%"
431800,Rs-Sao Borja,202503,7113,7338,9162,23613,61.323,"38,51%","11,60%"
431805,Rs-Sao Domingos do Sul,202503,26,128,405,559,2.808,"19,91%","0,93%"
431810,Rs-Sao Francisco de Assis,202503,3452,1858,3322,8632,17.949,"48,09%","19,23%"
431820,Rs-Sao Francisco de Paula,202503,3348,1870,2190,7408,22.373,"33,11%","14,96%"
431830,Rs-Sao Gabriel,202503,8146,7545,8506,24197,60.102,"40,26%","13,55%"
431840,Rs-Sao Jeronimo,202503,4155,2165,3121,9441,21.421,"44,07%","19,40%"
431842,Rs-Sao Joao da Urtiga,202503,111,395,1018,1524,4.549,"33,50%","2,44%"
431843,Rs-Sao Joao do Polesine,202503,318,242,448,1008,2.707,"37,24%","11,75%"
431844,Rs-Sao Jorge,202503,60,170,408,638,2.976,"21,44%","2,02%"
431845,Rs-Sao Jose das Missoes,202503,433,343,713,1489,2.403,"61,96%","18,02%"
431846,Rs-Sao Jose do Herval,202503,452,185,213,850,1.934,"43,95%","23,37%"
431848,Rs-Sao Jose do Hortencio,202503,96,144,270,510,4.551,"11,21%","2,11%"
431849,Rs-Sao Jose do Inhacora,202503,35,116,929,1080,2.463,"43,85%","1,42%"
431850,Rs-Sao Jose do Norte,202503,3897,5236,6260,15393,26.245,"58,65%","14,85%"
431860,Rs-Sao Jose do Ouro,202503,477,502,1028,2007,6.978,"28,76%","6,84%"
431861,Rs-Sao Jose do Sul,202503,63,114,154,331,2.440,"13,57%","2,58%"
431862,Rs-Sao Jose dos Ausentes,202503,1057,392,526,1975,4.286,"46,08%","24,66%"
431870,Rs-Sao Leopoldo,202503,37651,19596,27395,84642,225.669,"37,51%","16,68%"
431880,Rs-Sao Lourenco do Sul,202503,5034,3578,4430,13042,43.283,"30,13%","11,63%"
431890,Rs-Sao Luiz Gonzaga,202503,4359,4115,6872,15346,35.858,"42,80%","12,16%"
431900,Rs-Sao Marcos,202503,950,826,1473,3249,21.537,"15,09%","4,41%"
431910,Rs-Sao Martinho,202503,279,468,1428,2175,5.589,"38,92%","4,99%"
431912,Rs-Sao Martinho da Serra,202503,877,440,499,1816,2.911,"62,38%","30,13%"
431915,Rs-Sao Miguel das Missoes,202503,1645,618,838,3101,7.196,"43,09%","22,86%"
431920,Rs-Sao Nicolau,202503,1847,519,842,3208,5.248,"61,13%","35,19%"
431930,Rs-Sao Paulo das Missoes,202503,637,702,1104,2443,5.948,"41,07%","10,71%"
431935,Rs-Sao Pedro da Serra,202503,39,59,212,310,3.614,"8,58%","1,08%"
431936,Rs-Sao Pedro das Missoes,202503,334,174,516,1024,1.791,"57,17%","18,65%"
431937,Rs-Sao Pedro do Butia,202503,120,212,308,640,3.139,"20,39%","3,82%"
431940,Rs-Sao Pedro do Sul,202503,2333,2071,2925,7329,15.870,"46,18%","14,70%"
431950,Rs-Sao Sebastiao do Cai,202503,2112,2418,3736,8266,24.883,"33,22%","8,49%"
431960,Rs-Sao Sepe,202503,2587,3032,2910,8529,21.575,"39,53%","11,99%"
431970,Rs-Sao Valentim,202503,175,273,875,1323,3.324,"39,80%","5,26%"
431971,Rs-Sao Valentim do Sul,202503,90,75,175,340,2.255,"15,08%","3,99%"
431973,Rs-Sao Valerio do Sul,202503,1126,331,589,2046,2.594,"78,87%","43,41%"
431975,Rs-Sao Vendelino,202503,41,94,378,513,2.306,"22,25%","1,78%"
431980,Rs-Sao Vicente do Sul,202503,1746,788,981,3515,8.259,"42,56%","21,14%"
431990,Rs-Sapiranga,202503,10532,5912,7172,23616,77.898,"30,32%","13,52%"
432000,Rs-Sapucaia do Sul,202503,21108,10792,16174,48074,136.542,"35,21%","15,46%"
432010,Rs-Sarandi,202503,2524,2208,3519,8251,23.356,"35,33%","10,81%"
432020,Rs-Seberi,202503,1317,1499,2301,5117,12.313,"41,56%","10,70%"
432023,Rs-Sede Nova,202503,321,335,979,1635,2.753,"59,39%","11,66%"
432026,Rs-Segredo,202503,1634,739,635,3008,6.107,"49,25%","26,76%"
432030,Rs-Selbach,202503,245,417,735,1397,5.220,"26,76%","4,69%"
432032,Rs-Senador Salgado Filho,202503,292,243,391,926,2.726,"33,97%","10,71%"
432035,Rs-Sentinela do Sul,202503,1134,597,639,2370,5.422,"43,71%","20,91%"
432040,Rs-Serafina Correa,202503,602,759,1797,3158,17.379,"18,17%","3,46%"
432045,Rs-Serio,202503,55,211,288,554,2.093,"26,47%","2,63%"
432050,Rs-Sertao,202503,563,458,618,1639,5.637,"29,08%","9,99%"
432055,Rs-Sertao Santana,202503,936,469,753,2158,5.988,"36,04%","15,63%"
432057,Rs-Sete de Setembro,202503,200,135,246,581,1.884,"30,84%","10,62%"
432060,Rs-Severiano de Almeida,202503,143,284,1014,1441,3.467,"41,56%","4,12%"
432065,Rs-Silveira Martins,202503,302,170,246,718,2.060,"34,85%","14,66%"
432067,Rs-Sinimbu,202503,1331,713,879,2923,8.698,"33,61%","15,30%"
432070,Rs-Sobradinho,202503,1444,1452,1393,4289,14.512,"29,55%","9,95%"
432080,Rs-Soledade,202503,4857,3841,6092,14790,30.936,"47,81%","15,70%"
432085,Rs-Tabai,202503,602,386,358,1346,4.565,"29,49%","13,19%"
432090,Rs-Tapejara,202503,1695,2329,4563,8587,25.201,"34,07%","6,73%"
432100,Rs-Tapera,202503,268,924,1196,2388,10.822,"22,07%","2,48%"
432110,Rs-Tapes,202503,2328,2121,2167,6616,14.938,"44,29%","15,58%"
432120,Rs-Taquara,202503,5254,4016,4312,13582,54.360,"24,99%","9,67%"
432130,Rs-Taquari,202503,3667,2011,2654,8332,25.968,"32,09%","14,12%"
432132,Rs-Taquarucu do Sul,202503,239,221,543,1003,3.190,"31,44%","7,49%"
432135,Rs-Tavares,202503,1007,605,1041,2653,5.319,"49,88%","18,93%"
432140,Rs-Tenente Portela,202503,3220,1345,1674,6239,14.811,"42,12%","21,74%"
432143,Rs-Terra de Areia,202503,2058,1422,1690,5170,10.569,"48,92%","19,47%"
432145,Rs-Teutonia,202503,1320,1842,3427,6589,33.963,"19,40%","3,89%"
432146,Rs-Tio Hugo,202503,117,170,177,464,3.352,"13,84%","3,49%"
432147,Rs-Tiradentes do Sul,202503,356,538,897,1791,5.201,"34,44%","6,84%"
432149,Rs-Toropi,202503,357,259,826,1442,2.598,"55,50%","13,74%"
432150,Rs-Torres,202503,6017,3623,4479,14119,43.268,"32,63%","13,91%"
432160,Rs-Tramandai,202503,9955,6173,6406,22534,56.296,"40,03%","17,68%"
432162,Rs-Travesseiro,202503,22,68,577,667,2.193,"30,41%","1,00%"
432163,Rs-Tres Arroios,202503,13,63,558,634,2.638,"24,03%","0,49%"
432166,Rs-Tres Cachoeiras,202503,655,802,819,2276,11.216,"20,29%","5,84%"
432170,Rs-Tres Coroas,202503,1394,1862,2337,5593,24.420,"22,90%","5,71%"
432180,Rs-Tres de Maio,202503,2123,2053,3914,8090,25.452,"31,79%","8,34%"
432183,Rs-Tres Forquilhas,202503,667,355,501,1523,2.814,"54,12%","23,70%"
432185,Rs-Tres Palmeiras,202503,741,643,1319,2703,4.826,"56,01%","15,35%"
432190,Rs-Tres Passos,202503,2770,1639,2851,7260,26.284,"27,62%","10,54%"
432195,Rs-Trindade do Sul,202503,800,836,1607,3243,7.766,"41,76%","10,30%"
432200,Rs-Triunfo,202503,4892,2894,5108,12894,28.414,"45,38%","17,22%"
432210,Rs-Tucunduva,202503,417,394,553,1364,5.649,"24,15%","7,38%"
432215,Rs-Tunas,202503,913,654,631,2198,3.739,"58,79%","24,42%"
432218,Rs-Tupanci do Sul,202503,133,178,452,763,1.398,"54,58%","9,51%"
432220,Rs-Tupancireta,202503,4700,2228,3684,10612,20.345,"52,16%","23,10%"
432225,Rs-Tupandi,202503,148,172,195,515,5.160,"9,98%","2,87%"
432230,Rs-Tuparendi,202503,426,582,936,1944,8.536,"22,77%","4,99%"
432232,Rs-Turucu,202503,432,375,614,1421,3.489,"40,73%","12,38%"
432234,Rs-Ubiretama,202503,175,199,424,798,2.028,"39,35%","8,63%"
432235,Rs-Uniao da Serra,202503,49,27,72,148,1.186,"12,48%","4,13%"
432237,Rs-Unistalda,202503,478,201,137,816,2.052,"39,77%","23,29%"
432240,Rs-Uruguaiana,202503,22623,12158,13870,48651,120.885,"40,25%","18,71%"
432250,Rs-Vacaria,202503,10184,6603,9799,26586,66.110,"40,21%","15,40%"
432252,Rs-Vale Verde,202503,455,392,619,1466,3.214,"45,61%","14,16%"
432253,Rs-Vale do Sol,202503,1307,950,1199,3456,10.080,"34,29%","12,97%"
432254,Rs-Vale Real,202503,160,296,1529,1985,6.213,"31,95%","2,58%"
432255,Rs-Vanini,202503,80,90,346,516,2.047,"25,21%","3,91%"
432260,Rs-Venancio Aires,202503,6716,4983,8119,19818,70.805,"27,99%","9,49%"
432270,Rs-Vera Cruz,202503,3492,2093,2526,8111,27.638,"29,35%","12,63%"
432280,Rs-Veranopolis,202503,467,1047,2106,3620,24.540,"14,75%","1,90%"
432285,Rs-Vespasiano Correa,202503,39,61,441,541,1.852,"29,21%","2,11%"
432290,Rs-Viadutos,202503,374,273,535,1182,4.852,"24,36%","7,71%"
432300,Rs-Viamao,202503,46711,23821,29994,100526,232.113,"43,31%","20,12%"
432310,Rs-Vicente Dutra,202503,1654,540,896,3090,4.747,"65,09%","34,84%"
432320,Rs-Victor Graeff,202503,120,170,311,601,2.832,"21,22%","4,24%"
432330,Rs-Vila Flores,202503,85,94,354,533,3.736,"14,27%","2,28%"
432335,Rs-Vila Langaro,202503,36,177,416,629,2.122,"29,64%","1,70%"
432340,Rs-Vila Maria,202503,227,260,693,1180,4.512,"26,15%","5,03%"
432345,Rs-Vila Nova do Sul,202503,1444,281,409,2134,3.935,"54,23%","36,70%"
432350,Rs-Vista Alegre,202503,251,259,515,1025,2.712,"37,79%","9,26%"
432360,Rs-Vista Alegre do Prata,202503,62,82,684,828,1.624,"50,99%","3,82%"
432370,Rs-Vista Gaucha,202503,235,303,583,1121,2.842,"39,44%","8,27%"
432375,Rs-Vitoria das Missoes,202503,460,410,627,1497,3.318,"45,12%","13,86%"
432377,Rs-Westfalia,202503,43,109,429,581,3.219,"18,05%","1,34%"
432380,Rs-Xangri-La,202503,1739,2209,2741,6689,16.907,"39,56%","10,29%"
500020,Ms-Agua Clara,202503,4588,1953,3472,10013,17.647,"56,74%","26,00%"
500025,Ms-Alcinopolis,202503,1184,597,1202,2983,4.648,"64,18%","25,47%"
500060,Ms-Amambai,202503,13144,6154,6914,26212,41.414,"63,29%","31,74%"
500070,Ms-Anastacio,202503,5835,4104,5144,15083,24.741,"60,96%","23,58%"
500080,Ms-Anaurilandia,202503,1396,1095,1759,4250,7.735,"54,95%","18,05%"
500085,Ms-Angelica,202503,2130,1426,2378,5934,11.203,"52,97%","19,01%"
500090,Ms-Antonio Joao,202503,1920,2206,1767,5893,9.641,"61,12%","19,91%"
500100,Ms-Aparecida do Taboado,202503,4547,3839,3913,12299,29.446,"41,77%","15,44%"
500110,Ms-Aquidauana,202503,13928,7924,10778,32630,48.561,"67,19%","28,68%"
500124,Ms-Aral Moreira,202503,3941,1607,1516,7064,11.085,"63,73%","35,55%"
500150,Ms-Bandeirantes,202503,2032,958,1177,4167,8.276,"50,35%","24,55%"
500190,Ms-Bataguassu,202503,3789,4470,5665,13924,24.004,"58,01%","15,78%"
500200,Ms-Bataipora,202503,2342,1538,2887,6767,10.953,"61,78%","21,38%"
500210,Ms-Bela Vista,202503,7670,2768,3602,14040,21.965,"63,92%","34,92%"
500215,Ms-Bodoquena,202503,1902,1180,1445,4527,8.849,"51,16%","21,49%"
500220,Ms-Bonito,202503,4832,3359,3310,11501,24.761,"46,45%","19,51%"
500230,Ms-Brasilandia,202503,2680,1795,1956,6431,11.840,"54,32%","22,64%"
500240,Ms-Caarapo,202503,4340,5068,4110,13518,32.406,"41,71%","13,39%"
500260,Ms-Camapua,202503,3288,1679,2926,7893,13.920,"56,70%","23,62%"
500270,Ms-Campo Grande,202503,132535,115173,146098,393806,954.537,"41,26%","13,88%"
500280,Ms-Caracol,202503,1764,979,1278,4021,5.115,"78,61%","34,49%"
500290,Ms-Cassilandia,202503,2621,3009,4253,9883,21.549,"45,86%","12,16%"
500295,Ms-Chapadao do Sul,202503,3699,3763,4576,12038,33.791,"35,62%","10,95%"
500310,Ms-Corguinho,202503,901,581,906,2388,4.893,"48,80%","18,41%"
500315,Ms-Coronel Sapucaia,202503,9167,2026,2030,13223,14.661,"90,19%","62,53%"
500320,Ms-Corumba,202503,28581,15089,18959,62629,99.107,"63,19%","28,84%"
500325,Ms-Costa Rica,202503,7605,3583,5394,16582,28.163,"58,88%","27,00%"
500330,Ms-Coxim,202503,6968,4563,6162,17693,33.390,"52,99%","20,87%"
500345,Ms-Deodapolis,202503,1421,2066,2859,6346,14.210,"44,66%","10,00%"
500348,Ms-Dois Irmaos do Buriti,202503,3618,1638,2050,7306,11.470,"63,70%","31,54%"
500350,Ms-Douradina,202503,1036,1094,1646,3776,5.749,"65,68%","18,02%"
500370,Ms-Dourados,202503,31151,27186,24308,82645,260.640,"31,71%","11,95%"
500375,Ms-Eldorado,202503,2055,2328,3131,7514,11.633,"64,59%","17,67%"
500380,Ms-Fatima do Sul,202503,2182,3854,4636,10672,21.388,"49,90%","10,20%"
500390,Ms-Figueirao,202503,777,381,632,1790,3.709,"48,26%","20,95%"
500400,Ms-Gloria de Dourados,202503,1330,1445,2260,5035,10.777,"46,72%","12,34%"
500410,Ms-Guia Lopes da Laguna,202503,2728,1604,1956,6288,10.135,"62,04%","26,92%"
500430,Ms-Iguatemi,202503,2219,2940,3165,8324,14.017,"59,39%","15,83%"
500440,Ms-Inocencia,202503,994,1076,2200,4270,8.712,"49,01%","11,41%"
500450,Ms-Itapora,202503,1958,2099,2416,6473,25.075,"25,81%","7,81%"
500460,Ms-Itaquirai,202503,2024,4606,4879,11509,19.996,"57,56%","10,12%"
500470,Ms-Ivinhema,202503,2608,3330,4114,10052,29.613,"33,94%","8,81%"
500480,Ms-Japora,202503,4038,1675,1222,6935,8.409,"82,47%","48,02%"
500490,Ms-Jaraguari,202503,977,996,1301,3274,7.425,"44,09%","13,16%"
500500,Ms-Jardim,202503,3318,5163,4020,12501,24.509,"51,01%","13,54%"
500510,Ms-Jatei,202503,869,424,763,2056,3.620,"56,80%","24,01%"
500515,Ms-Juti,202503,1843,1190,1477,4510,7.009,"64,35%","26,29%"
500520,Ms-Ladario,202503,5779,2595,2495,10869,22.290,"48,76%","25,93%"
500525,Ms-Laguna Carapa,202503,1535,1183,912,3630,7.012,"51,77%","21,89%"
500540,Ms-Maracaju,202503,4867,6104,7438,18409,47.558,"38,71%","10,23%"
500560,Ms-Miranda,202503,10104,3571,4161,17836,26.487,"67,34%","38,15%"
500568,Ms-Mundo Novo,202503,5446,3270,4499,13215,19.937,"66,28%","27,32%"
500570,Ms-Navirai,202503,9505,6318,8842,24665,52.707,"46,80%","18,03%"
500580,Ms-Nioaque,202503,3974,2494,2987,9455,13.412,"70,50%","29,63%"
500600,Ms-Nova Alvorada do Sul,202503,3710,3456,4206,11372,23.054,"49,33%","16,09%"
500620,Ms-Nova Andradina,202503,8578,6712,10321,25611,50.610,"50,60%","16,95%"
500625,Ms-Novo Horizonte do Sul,202503,484,526,666,1676,4.811,"34,84%","10,06%"
500627,Ms-Paraiso das Aguas,202503,459,816,1039,2314,5.777,"40,06%","7,95%"
500630,Ms-Paranaiba,202503,5331,5894,9549,20774,42.543,"48,83%","12,53%"
500635,Ms-Paranhos,202503,6524,2002,1544,10070,13.323,"75,58%","48,97%"
500640,Ms-Pedro Gomes,202503,2056,855,1233,4144,6.974,"59,42%","29,48%"
500660,Ms-Ponta Pora,202503,25984,19297,20012,65293,97.577,"66,91%","26,63%"
500690,Ms-Porto Murtinho,202503,3927,1960,2511,8398,12.864,"65,28%","30,53%"
500710,Ms-Ribas do Rio Pardo,202503,2122,4336,4657,11115,23.996,"46,32%","8,84%"
500720,Ms-Rio Brilhante,202503,4321,5270,6255,15846,39.936,"39,68%","10,82%"
500730,Ms-Rio Negro,202503,793,942,1192,2927,4.933,"59,34%","16,08%"
500740,Ms-Rio Verde de Mato Grosso,202503,5063,3368,3786,12217,20.393,"59,91%","24,83%"
500750,Ms-Rochedo,202503,1178,1070,1169,3417,5.407,"63,20%","21,79%"
500755,Ms-Santa Rita do Pardo,202503,887,1217,1617,3721,7.174,"51,87%","12,36%"
500769,Ms-Sao Gabriel do Oeste,202503,2989,4660,7074,14723,31.694,"46,45%","9,43%"
500770,Ms-Sete Quedas,202503,1684,1695,1107,4486,11.301,"39,70%","14,90%"
500780,Ms-Selviria,202503,870,1389,1970,4229,8.593,"49,21%","10,12%"
500790,Ms-Sidrolandia,202503,8666,7861,9744,26271,49.374,"53,21%","17,55%"
500793,Ms-Sonora,202503,2490,1818,2209,6517,14.822,"43,97%","16,80%"
500795,Ms-Tacuru,202503,3927,2011,1701,7639,11.159,"68,46%","35,19%"
500797,Ms-Taquarussu,202503,908,514,920,2342,3.730,"62,79%","24,34%"
500800,Ms-Terenos,202503,3286,2828,3593,9707,18.139,"53,51%","18,12%"
500830,Ms-Tres Lagoas,202503,17729,17434,24548,59711,141.435,"42,22%","12,54%"
500840,Ms-Vicentina,202503,1239,965,1502,3706,6.476,"57,23%","19,13%"
510010,Mt-Acorizal,202503,2182,781,1014,3977,4.990,"79,70%","43,73%"
510020,Mt-Agua Boa,202503,2044,3637,6601,12282,31.314,"39,22%","6,53%"
510025,Mt-Alta Floresta,202503,8696,6201,8748,23645,61.291,"38,58%","14,19%"
510030,Mt-Alto Araguaia,202503,2490,1992,3514,7996,17.657,"45,29%","14,10%"
510035,Mt-Alto Boa Vista,202503,1639,971,889,3499,5.875,"59,56%","27,90%"
510040,Mt-Alto Garcas,202503,2693,1485,1813,5991,13.707,"43,71%","19,65%"
510050,Mt-Alto Paraguai,202503,2741,947,1562,5250,7.717,"68,03%","35,52%"
510060,Mt-Alto Taquari,202503,1329,1391,1830,4550,11.571,"39,32%","11,49%"
510080,Mt-Apiacas,202503,1615,1830,1561,5006,8.692,"57,59%","18,58%"
510100,Mt-Araguaiana,202503,781,407,489,1677,3.950,"42,46%","19,77%"
510120,Mt-Araguainha,202503,298,89,240,627,1.006,"62,33%","29,62%"
510125,Mt-Araputanga,202503,1693,2270,2235,6198,14.854,"41,73%","11,40%"
510130,Mt-Arenapolis,202503,2057,1163,1702,4922,10.747,"45,80%","19,14%"
510140,Mt-Aripuana,202503,4712,2934,2315,9961,26.010,"38,30%","18,12%"
510160,Mt-Barao de Melgaco,202503,3687,680,1250,5617,7.204,"77,97%","51,18%"
510170,Mt-Barra do Bugres,202503,6725,3537,4561,14823,29.576,"50,12%","22,74%"
510180,Mt-Barra do Garcas,202503,15769,8780,11464,36013,72.694,"49,54%","21,69%"
510185,Mt-Bom Jesus do Araguaia,202503,2005,1342,1473,4820,7.731,"62,35%","25,93%"
510190,Mt-Brasnorte,202503,2564,2596,3049,8209,17.496,"46,92%","14,65%"
510250,Mt-Caceres,202503,21406,14630,14193,50229,91.626,"54,82%","23,36%"
510260,Mt-Campinapolis,202503,7262,2023,923,10208,15.713,"64,97%","46,22%"
510263,Mt-Campo Novo do Parecis,202503,2074,5420,5838,13332,50.033,"26,65%","4,15%"
510267,Mt-Campo Verde,202503,3569,6430,9469,19468,47.831,"40,70%","7,46%"
510268,Mt-Campos de Julio,202503,792,1654,1770,4216,9.608,"43,88%","8,24%"
510269,Mt-Canabrava do Norte,202503,1203,698,945,2846,4.480,"63,53%","26,85%"
510270,Mt-Canarana,202503,2718,3393,2429,8540,27.657,"30,88%","9,83%"
510279,Mt-Carlinda,202503,1046,1886,2510,5442,10.324,"52,71%","10,13%"
510285,Mt-Castanheira,202503,1229,926,1195,3350,7.459,"44,91%","16,48%"
510300,Mt-Chapada dos Guimaraes,202503,6019,2472,2641,11132,19.374,"57,46%","31,07%"
510305,Mt-Claudia,202503,2092,1434,1440,4966,9.436,"52,63%","22,17%"
510310,Mt-Cocalinho,202503,1435,893,913,3241,6.428,"50,42%","22,32%"
510320,Mt-Colider,202503,2696,3998,5408,12102,32.010,"37,81%","8,42%"
510325,Mt-Colniza,202503,3954,6356,4456,14766,26.090,"56,60%","15,16%"
510330,Mt-Comodoro,202503,5113,2053,2400,9566,18.461,"51,82%","27,70%"
510335,Mt-Confresa,202503,7437,4879,3974,16290,37.541,"43,39%","19,81%"
510336,Mt-Conquista D Oeste,202503,928,487,554,1969,3.874,"50,83%","23,95%"
510337,Mt-Cotriguacu,202503,1986,1543,1384,4913,10.398,"47,25%","19,10%"
510340,Mt-Cuiaba,202503,96049,74311,88172,258532,682.932,"37,86%","14,06%"
510343,Mt-Curvelandia,202503,1410,685,1134,3229,4.967,"65,01%","28,39%"
510345,Mt-Denise,202503,1680,812,1469,3961,6.815,"58,12%","24,65%"
510350,Mt-Diamantino,202503,2282,3488,4118,9888,22.479,"43,99%","10,15%"
510360,Mt-Dom Aquino,202503,1998,820,1471,4289,7.915,"54,19%","25,24%"
510370,Mt-Feliz Natal,202503,3389,1375,1173,5937,10.564,"56,20%","32,08%"
510380,Mt-Figueiropolis D Oeste,202503,670,252,646,1568,3.112,"50,39%","21,53%"
510385,Mt-Gaucha do Norte,202503,3169,941,932,5042,9.181,"54,92%","34,52%"
510390,Mt-General Carneiro,202503,2485,889,987,4361,6.250,"69,78%","39,76%"
510395,Mt-Gloria D Oeste,202503,846,321,493,1660,2.899,"57,26%","29,18%"
510410,Mt-Guaranta do Norte,202503,8113,3491,3971,15575,31.328,"49,72%","25,90%"
510420,Mt-Guiratinga,202503,3025,964,1903,5892,10.532,"55,94%","28,72%"
510450,Mt-Indiavai,202503,459,293,600,1352,2.194,"61,62%","20,92%"
510452,Mt-Ipiranga do Norte,202503,1969,692,989,3650,8.409,"43,41%","23,42%"
510454,Mt-Itanhanga,202503,1484,847,1168,3499,8.049,"43,47%","18,44%"
510455,Mt-Itauba,202503,891,1013,1207,3111,5.161,"60,28%","17,26%"
510460,Mt-Itiquira,202503,1905,1668,2007,5580,12.519,"44,57%","15,22%"
510480,Mt-Jaciara,202503,4932,3318,5546,13796,29.560,"46,67%","16,68%"
510490,Mt-Jangada,202503,2582,1229,1176,4987,7.447,"66,97%","34,67%"
510500,Mt-Jauru,202503,1374,1107,1333,3814,8.076,"47,23%","17,01%"
510510,Mt-Juara,202503,4932,4130,4211,13273,35.899,"36,97%","13,74%"
510515,Mt-Juina,202503,5635,5482,4545,15662,47.800,"32,77%","11,79%"
510517,Mt-Juruena,202503,2336,1431,1682,5449,10.149,"53,69%","23,02%"
510520,Mt-Juscimeira,202503,1673,1267,2859,5799,11.620,"49,91%","14,40%"
510523,Mt-Lambari D Oeste,202503,1307,746,982,3035,4.724,"64,25%","27,67%"
510525,Mt-Lucas do Rio Verde,202503,8213,9280,12705,30198,92.256,"32,73%","8,90%"
510530,Mt-Luciara,202503,1119,368,427,1914,2.591,"73,87%","43,19%"
510550,Mt-Vila Bela da Santissima Trindade,202503,4109,2356,2278,8743,17.384,"50,29%","23,64%"
510558,Mt-Marcelandia,202503,2955,2094,1851,6900,11.414,"60,45%","25,89%"
510560,Mt-Matupa,202503,1447,3016,2829,7292,21.415,"34,05%","6,76%"
510562,Mt-Mirassol D Oeste,202503,6675,4084,5466,16225,27.511,"58,98%","24,26%"
510590,Mt-Nobres,202503,4857,2195,2882,9934,15.753,"63,06%","30,83%"
510600,Mt-Nortelandia,202503,1152,844,1077,3073,5.935,"51,78%","19,41%"
510610,Mt-Nossa Senhora do Livramento,202503,3608,1912,2582,8102,11.658,"69,50%","30,95%"
510615,Mt-Nova Bandeirantes,202503,2664,2961,2413,8038,14.160,"56,77%","18,81%"
510617,Mt-Nova Nazare,202503,2567,616,668,3851,4.467,"86,21%","57,47%"
510618,Mt-Nova Lacerda,202503,1933,856,1223,4012,6.965,"57,60%","27,75%"
510619,Mt-Nova Santa Helena,202503,372,840,853,2065,4.431,"46,60%","8,40%"
510620,Mt-Nova Brasilandia,202503,904,892,1528,3324,3.853,"86,27%","23,46%"
510621,Mt-Nova Canaa do Norte,202503,900,1984,2126,5010,11.771,"42,56%","7,65%"
510622,Mt-Nova Mutum,202503,3138,6810,8947,18895,61.223,"30,86%","5,13%"
510623,Mt-Nova Olimpia,202503,3012,2085,2909,8006,16.314,"49,07%","18,46%"
510624,Mt-Nova Ubirata,202503,632,1981,1781,4394,9.589,"45,82%","6,59%"
510625,Mt-Nova Xavantina,202503,3729,3023,4191,10943,25.486,"42,94%","14,63%"
510626,Mt-Novo Mundo,202503,1411,1278,1105,3794,6.444,"58,88%","21,90%"
510627,Mt-Novo Horizonte do Norte,202503,599,539,817,1955,3.307,"59,12%","18,11%"
510628,Mt-Novo Sao Joaquim,202503,1471,944,1034,3449,7.160,"48,17%","20,54%"
510629,Mt-Paranaita,202503,1436,2031,2351,5818,11.989,"48,53%","11,98%"
510630,Mt-Paranatinga,202503,4133,2990,3426,10549,28.204,"37,40%","14,65%"
510631,Mt-Novo Santo Antonio,202503,797,289,334,1420,2.040,"69,61%","39,07%"
510637,Mt-Pedra Preta,202503,3434,3006,3443,9883,18.722,"52,79%","18,34%"
510642,Mt-Peixoto de Azevedo,202503,8288,5039,4373,17700,33.599,"52,68%","24,67%"
510645,Mt-Planalto da Serra,202503,962,606,782,2350,3.287,"71,49%","29,27%"
510650,Mt-Pocone,202503,11858,3590,5015,20463,31.269,"65,44%","37,92%"
510665,Mt-Pontal do Araguaia,202503,1385,960,1510,3855,7.299,"52,82%","18,98%"
510670,Mt-Ponte Branca,202503,552,181,289,1022,2.076,"49,23%","26,59%"
510675,Mt-Pontes e Lacerda,202503,5937,7601,7260,20798,54.795,"37,96%","10,83%"
510677,Mt-Porto Alegre do Norte,202503,3331,1458,1590,6379,12.524,"50,93%","26,60%"
510680,Mt-Porto dos Gauchos,202503,479,609,1032,2120,5.690,"37,26%","8,42%"
510682,Mt-Porto Esperidiao,202503,3039,1533,1508,6080,10.167,"59,80%","29,89%"
510685,Mt-Porto Estrela,202503,796,450,595,1841,3.181,"57,87%","25,02%"
510700,Mt-Poxoreo,202503,4798,2973,3383,11154,24.587,"45,37%","19,51%"
510704,Mt-Primavera do Leste,202503,8489,10242,12132,30863,92.927,"33,21%","9,14%"
510706,Mt-Querencia,202503,5653,2623,2463,10739,29.820,"36,01%","18,96%"
510710,Mt-Sao Jose dos Quatro Marcos,202503,2553,2338,3431,8322,17.830,"46,67%","14,32%"
510715,Mt-Reserva do Cabacal,202503,653,389,668,1710,2.062,"82,93%","31,67%"
510718,Mt-Ribeirao Cascalheira,202503,3133,1212,1783,6128,10.431,"58,75%","30,04%"
510719,Mt-Ribeiraozinho,202503,461,357,479,1297,2.697,"48,09%","17,09%"
510720,Mt-Rio Branco,202503,744,729,671,2144,4.489,"47,76%","16,57%"
510724,Mt-Santa Carmem,202503,769,1011,1011,2791,5.677,"49,16%","13,55%"
510726,Mt-Santo Afonso,202503,800,328,524,1652,2.460,"67,15%","32,52%"
510729,Mt-Sao Jose do Povo,202503,307,500,982,1789,2.780,"64,35%","11,04%"
510730,Mt-Sao Jose do Rio Claro,202503,3069,2154,2637,7860,14.662,"53,61%","20,93%"
510735,Mt-Sao Jose do Xingu,202503,2531,1071,926,4528,6.168,"73,41%","41,03%"
510740,Mt-Sao Pedro da Cipa,202503,1052,462,1078,2592,4.247,"61,03%","24,77%"
510757,Mt-Rondolandia,202503,683,818,701,2202,3.527,"62,43%","19,36%"
510760,Mt-Rondonopolis,202503,26601,36470,47465,110536,259.167,"42,65%","10,26%"
510770,Mt-Rosario Oeste,202503,5712,1822,2741,10275,15.236,"67,44%","37,49%"
510774,Mt-Santa Cruz do Xingu,202503,742,342,368,1452,2.834,"51,24%","26,18%"
510775,Mt-Salto do Ceu,202503,455,745,941,2141,3.679,"58,20%","12,37%"
510776,Mt-Santa Rita do Trivelato,202503,866,495,1084,2445,3.463,"70,60%","25,01%"
510777,Mt-Santa Terezinha,202503,2137,1184,1071,4392,7.720,"56,89%","27,68%"
510779,Mt-Santo Antonio do Leste,202503,1138,684,816,2638,4.212,"62,63%","27,02%"
510780,Mt-Santo Antonio do Leverger,202503,5279,3194,3778,12251,16.795,"72,94%","31,43%"
510785,Mt-Sao Felix do Araguaia,202503,2239,1504,2266,6009,14.332,"41,93%","15,62%"
510787,Mt-Sapezal,202503,3765,3597,4980,12342,31.499,"39,18%","11,95%"
510788,Mt-Serra Nova Dourada,202503,589,336,438,1363,1.901,"71,70%","30,98%"
510790,Mt-Sinop,202503,10040,29187,25925,65152,216.029,"30,16%","4,65%"
510792,Mt-Sorriso,202503,10974,14277,15136,40387,120.561,"33,50%","9,10%"
510794,Mt-Tabapora,202503,1081,1734,1128,3943,9.908,"39,80%","10,91%"
510795,Mt-Tangara da Serra,202503,12385,12451,12359,37195,112.547,"33,05%","11,00%"
510800,Mt-Tapurah,202503,1242,1726,1641,4609,15.272,"30,18%","8,13%"
510805,Mt-Terra Nova do Norte,202503,1465,1611,1887,4963,10.641,"46,64%","13,77%"
510810,Mt-Tesouro,202503,934,244,520,1698,2.977,"57,04%","31,37%"
510820,Mt-Torixoreu,202503,733,352,611,1696,4.230,"40,09%","17,33%"
510830,Mt-Uniao do Sul,202503,1157,629,418,2204,3.897,"56,56%","29,69%"
510835,Mt-Vale de Sao Domingos,202503,639,543,619,1801,2.907,"61,95%","21,98%"
510840,Mt-Varzea Grande,202503,78597,34481,46660,159738,314.627,"50,77%","24,98%"
510850,Mt-Vera,202503,1335,2148,2518,6001,10.584,"56,70%","12,61%"
510860,Mt-Vila Rica,202503,3911,2223,2308,8442,19.827,"42,58%","19,73%"
510880,Mt-Nova Guarita,202503,593,1019,692,2304,4.579,"50,32%","12,95%"
510885,Mt-Nova Marilandia,202503,560,511,694,1765,3.678,"47,99%","15,23%"
510890,Mt-Nova Maringa,202503,1005,903,912,2820,5.775,"48,83%","17,40%"
510895,Mt-Nova Monte Verde,202503,1808,1099,1564,4471,8.451,"52,90%","21,39%"
520005,Go-Abadia de Goias,202503,6955,3873,2995,13823,21.165,"65,31%","32,86%"
520010,Go-Abadiania,202503,3442,2897,3324,9663,17.638,"54,79%","19,51%"
520013,Go-Acreuna,202503,3001,3559,4902,11462,21.995,"52,11%","13,64%"
520015,Go-Adelandia,202503,477,516,482,1475,2.297,"64,21%","20,77%"
520017,Go-Agua Fria de Goias,202503,1168,1096,1266,3530,4.991,"70,73%","23,40%"
520020,Go-Agua Limpa,202503,700,294,324,1318,1.856,"71,01%","37,72%"
520025,Go-Aguas Lindas de Goias,202503,66710,34445,25317,126472,240.613,"52,56%","27,73%"
520030,Go-Alexania,202503,10370,3520,4187,18077,28.009,"64,54%","37,02%"
520050,Go-Aloandia,202503,402,302,546,1250,1.984,"63,00%","20,26%"
520055,Go-Alto Horizonte,202503,1568,861,2251,4680,6.375,"73,41%","24,60%"
520060,Go-Alto Paraiso de Goias,202503,2288,1599,1829,5716,10.936,"52,27%","20,92%"
520080,Go-Alvorada do Norte,202503,2154,1723,1582,5459,8.597,"63,50%","25,06%"
520082,Go-Amaralina,202503,815,627,961,2403,3.281,"73,24%","24,84%"
520085,Go-Americano do Brasil,202503,1065,873,894,2832,5.281,"53,63%","20,17%"
520090,Go-Amorinopolis,202503,1059,322,569,1950,2.952,"66,06%","35,87%"
520110,Go-Anapolis,202503,22602,59859,58449,140910,415.847,"33,89%","5,44%"
520120,Go-Anhanguera,202503,201,204,258,663,921,"71,99%","21,82%"
520130,Go-Anicuns,202503,3712,3055,3986,10753,18.443,"58,30%","20,13%"
520140,Go-Aparecida de Goiania,202503,44807,70541,56535,171883,550.925,"31,20%","8,13%"
520145,Go-Aparecida do Rio Doce,202503,399,557,665,1621,3.012,"53,82%","13,25%"
520150,Go-Apore,202503,911,577,918,2406,4.452,"54,04%","20,46%"
520160,Go-Aracu,202503,1007,624,961,2592,3.842,"67,46%","26,21%"
520170,Go-Aragarcas,202503,4734,2608,3927,11269,18.604,"60,57%","25,45%"
520180,Go-Aragoiania,202503,4525,1897,1763,8185,12.554,"65,20%","36,04%"
520215,Go-Araguapaz,202503,2377,1075,1299,4751,7.182,"66,15%","33,10%"
520235,Go-Arenopolis,202503,903,447,672,2022,2.930,"69,01%","30,82%"
520250,Go-Aruana,202503,1418,2222,1517,5157,8.515,"60,56%","16,65%"
520260,Go-Aurilandia,202503,549,549,799,1897,3.266,"58,08%","16,81%"
520280,Go-Avelinopolis,202503,919,491,617,2027,2.963,"68,41%","31,02%"
520310,Go-Baliza,202503,1103,441,738,2282,3.335,"68,43%","33,07%"
520320,Go-Barro Alto,202503,2313,1688,2801,6802,10.738,"63,35%","21,54%"
520330,Go-Bela Vista de Goias,202503,7086,3639,4027,14752,36.583,"40,32%","19,37%"
520340,Go-Bom Jardim de Goias,202503,2465,1186,1944,5595,7.824,"71,51%","31,51%"
520350,Go-Bom Jesus de Goias,202503,3245,2880,4003,10128,24.701,"41,00%","13,14%"
520355,Go-Bonfinopolis,202503,1909,1989,1876,5774,10.828,"53,32%","17,63%"
520357,Go-Bonopolis,202503,1421,425,599,2445,3.306,"73,96%","42,98%"
520360,Go-Brazabrantes,202503,754,654,753,2161,4.149,"52,08%","18,17%"
520380,Go-Britania,202503,953,1177,1776,3906,5.788,"67,48%","16,47%"
520390,Go-Buriti Alegre,202503,1283,1179,1241,3703,10.831,"34,19%","11,85%"
520393,Go-Buriti de Goias,202503,699,529,632,1860,2.789,"66,69%","25,06%"
520396,Go-Buritinopolis,202503,1242,533,583,2358,3.154,"74,76%","39,38%"
520400,Go-Cabeceiras,202503,2658,875,1032,4565,7.678,"59,46%","34,62%"
520410,Go-Cachoeira Alta,202503,2129,1307,1904,5340,11.789,"45,30%","18,06%"
520420,Go-Cachoeira de Goias,202503,518,155,254,927,1.419,"65,33%","36,50%"
520425,Go-Cachoeira Dourada,202503,1124,1105,2002,4231,7.801,"54,24%","14,41%"
520430,Go-Cacu,202503,1771,1896,2617,6284,14.006,"44,87%","12,64%"
520440,Go-Caiaponia,202503,1838,2833,4147,8818,16.655,"52,95%","11,04%"
520450,Go-Caldas Novas,202503,12448,14517,16374,43339,104.788,"41,36%","11,88%"
520455,Go-Caldazinha,202503,712,993,803,2508,4.735,"52,97%","15,04%"
520460,Go-Campestre de Goias,202503,1276,707,756,2739,3.854,"71,07%","33,11%"
520465,Go-Campinacu,202503,1352,466,490,2308,3.758,"61,42%","35,98%"
520470,Go-Campinorte,202503,3371,1857,1996,7224,12.879,"56,09%","26,17%"
520480,Go-Campo Alegre de Goias,202503,1431,904,1069,3404,7.711,"44,14%","18,56%"
520485,Go-Campo Limpo de Goias,202503,3665,1087,1049,5801,8.449,"68,66%","43,38%"
520490,Go-Campos Belos,202503,6292,2944,3593,12829,18.258,"70,27%","34,46%"
520495,Go-Campos Verdes,202503,2150,654,949,3753,3.899,"96,26%","55,14%"
520500,Go-Carmo do Rio Verde,202503,2429,1133,2007,5569,9.937,"56,04%","24,44%"
520505,Go-Castelandia,202503,1248,463,464,2175,2.921,"74,46%","42,73%"
520510,Go-Catalao,202503,13881,8795,9399,32075,120.789,"26,55%","11,49%"
520520,Go-Caturai,202503,1595,987,898,3480,5.318,"65,44%","29,99%"
520530,Go-Cavalcante,202503,3694,2100,2335,8129,9.721,"83,62%","38,00%"
520540,Go-Ceres,202503,2314,2871,3907,9092,22.484,"40,44%","10,29%"
520545,Go-Cezarina,202503,1569,1424,1363,4356,8.265,"52,70%","18,98%"
520547,Go-Chapadao do Ceu,202503,2183,1112,1512,4807,13.897,"34,59%","15,71%"
520549,Go-Cidade Ocidental,202503,26634,13445,11382,51461,98.963,"52,00%","26,91%"
520551,Go-Cocalzinho de Goias,202503,8557,3042,3177,14776,26.638,"55,47%","32,12%"
520552,Go-Colinas do Sul,202503,1436,690,836,2962,4.153,"71,32%","34,58%"
520570,Go-Corrego do Ouro,202503,501,350,518,1369,2.456,"55,74%","20,40%"
520580,Go-Corumba de Goias,202503,3038,1223,1753,6014,10.714,"56,13%","28,36%"
520590,Go-Corumbaiba,202503,1853,842,1049,3744,9.416,"39,76%","19,68%"
520620,Go-Cristalina,202503,16238,7278,7296,30812,65.705,"46,89%","24,71%"
520630,Go-Cristianopolis,202503,1176,672,756,2604,3.630,"71,74%","32,40%"
520640,Go-Crixas,202503,2335,2000,2465,6800,17.445,"38,98%","13,38%"
520650,Go-Crominia,202503,1299,520,740,2559,3.977,"64,34%","32,66%"
520660,Go-Cumari,202503,533,382,618,1533,2.955,"51,88%","18,04%"
520670,Go-Damianopolis,202503,1543,581,794,2918,3.884,"75,13%","39,73%"
520680,Go-Damolandia,202503,1207,469,688,2364,2.755,"85,81%","43,81%"
520690,Go-Davinopolis,202503,646,296,430,1372,1.901,"72,17%","33,98%"
520710,Go-Diorama,202503,367,326,572,1265,2.023,"62,53%","18,14%"
520725,Go-Doverlandia,202503,1603,797,1213,3613,6.895,"52,40%","23,25%"
520735,Go-Edealina,202503,983,652,808,2443,4.087,"59,77%","24,05%"
520740,Go-Edeia,202503,2133,2064,2425,6622,11.953,"55,40%","17,84%"
520750,Go-Estrela do Norte,202503,885,484,615,1984,3.224,"61,54%","27,45%"
520753,Go-Faina,202503,1789,1132,980,3901,7.164,"54,45%","24,97%"
520760,Go-Fazenda Nova,202503,2013,748,656,3417,5.878,"58,13%","34,25%"
520780,Go-Firminopolis,202503,1850,1214,1503,4567,10.365,"44,06%","17,85%"
520790,Go-Flores de Goias,202503,3827,1838,2800,8465,14.156,"59,80%","27,03%"
520800,Go-Formosa,202503,26290,14822,14999,56111,120.478,"46,57%","21,82%"
520810,Go-Formoso,202503,1240,744,754,2738,4.681,"58,49%","26,49%"
520815,Go-Gameleira de Goias,202503,648,701,761,2110,3.542,"59,57%","18,29%"
520830,Go-Divinopolis de Goias,202503,2357,761,899,4017,4.440,"90,47%","53,09%"
520840,Go-Goianapolis,202503,3843,3234,2300,9377,14.555,"64,42%","26,40%"
520850,Go-Goiandira,202503,797,678,1010,2485,4.986,"49,84%","15,98%"
520860,Go-Goianesia,202503,9995,10037,10916,30948,77.014,"40,18%","12,98%"
520870,Go-Goiania,202503,166711,128020,155185,449916,1.494.599,"30,10%","11,15%"
520880,Go-Goianira,202503,13209,11504,10249,34962,78.754,"44,39%","16,77%"
520890,Go-Goias,202503,4960,2972,4255,12187,24.233,"50,29%","20,47%"
520910,Go-Goiatuba,202503,3939,4943,5163,14045,36.777,"38,19%","10,71%"
520915,Go-Gouvelandia,202503,1106,558,781,2445,4.356,"56,13%","25,39%"
520920,Go-Guapo,202503,5941,2624,2967,11532,20.588,"56,01%","28,86%"
520929,Go-Guaraita,202503,662,589,567,1818,2.185,"83,20%","30,30%"
520940,Go-Guarani de Goias,202503,1269,854,871,2994,4.106,"72,92%","30,91%"
520945,Go-Guarinos,202503,496,332,453,1281,2.165,"59,17%","22,91%"
520960,Go-Heitorai,202503,1535,542,773,2850,3.360,"84,82%","45,68%"
520970,Go-Hidrolandia,202503,5313,4506,4135,13954,29.827,"46,78%","17,81%"
520980,Go-Hidrolina,202503,788,576,552,1916,3.514,"54,52%","22,42%"
520990,Go-Iaciara,202503,5395,1276,1720,8391,10.430,"80,45%","51,73%"
520993,Go-Inaciolandia,202503,977,888,1671,3536,6.061,"58,34%","16,12%"
520995,Go-Indiara,202503,2606,2342,2728,7676,17.747,"43,25%","14,68%"
521000,Go-Inhumas,202503,7291,8655,10667,26613,53.629,"49,62%","13,60%"
521010,Go-Ipameri,202503,5266,3482,4328,13076,26.163,"49,98%","20,13%"
521015,Go-Ipiranga de Goias,202503,887,421,665,1973,2.964,"66,57%","29,93%"
521020,Go-Ipora,202503,4202,4535,6579,15316,36.983,"41,41%","11,36%"
521030,Go-Israelandia,202503,857,277,529,1663,2.540,"65,47%","33,74%"
521040,Go-Itaberai,202503,7831,9098,8688,25617,46.943,"54,57%","16,68%"
521056,Go-Itaguari,202503,976,1202,1152,3330,5.088,"65,45%","19,18%"
521060,Go-Itaguaru,202503,1077,807,901,2785,4.880,"57,07%","22,07%"
521080,Go-Itaja,202503,715,751,1097,2563,4.328,"59,22%","16,52%"
521090,Go-Itapaci,202503,2455,3002,3741,9198,21.708,"42,37%","11,31%"
521100,Go-Itapirapua,202503,2311,1163,1286,4760,8.125,"58,58%","28,44%"
521120,Go-Itapuranga,202503,5333,4927,4466,14726,26.574,"55,42%","20,07%"
521130,Go-Itaruma,202503,1032,869,1454,3355,6.142,"54,62%","16,80%"
521140,Go-Itaucu,202503,2029,1171,1750,4950,7.701,"64,28%","26,35%"
521150,Go-Itumbiara,202503,15130,10427,13812,39369,112.289,"35,06%","13,47%"
521160,Go-Ivolandia,202503,856,363,664,1883,2.729,"69,00%","31,37%"
521170,Go-Jandaia,202503,859,1042,946,2847,6.360,"44,76%","13,51%"
521180,Go-Jaragua,202503,11043,7811,7226,26080,46.427,"56,17%","23,79%"
521190,Go-Jatai,202503,12000,10947,12969,35916,110.404,"32,53%","10,87%"
521200,Go-Jaupaci,202503,648,600,654,1902,2.946,"64,56%","22,00%"
521205,Go-Jesupolis,202503,898,336,397,1631,2.124,"76,79%","42,28%"
521210,Go-Joviania,202503,630,927,1233,2790,7.247,"38,50%","8,69%"
521220,Go-Jussara,202503,4476,2865,3667,11008,19.901,"55,31%","22,49%"
521225,Go-Lagoa Santa,202503,762,186,294,1242,1.426,"87,10%","53,44%"
521230,Go-Leopoldo de Bulhoes,202503,2556,993,1021,4570,9.035,"50,58%","28,29%"
521250,Go-Luziania,202503,56072,33910,27514,117496,218.872,"53,68%","25,62%"
521260,Go-Mairipotaba,202503,711,367,397,1475,2.618,"56,34%","27,16%"
521270,Go-Mambai,202503,3662,1030,1096,5788,8.405,"68,86%","43,57%"
521280,Go-Mara Rosa,202503,2563,1759,1902,6224,10.815,"57,55%","23,70%"
521290,Go-Marzagao,202503,566,426,584,1576,2.893,"54,48%","19,56%"
521295,Go-Matrincha,202503,1500,855,1062,3417,4.033,"84,73%","37,19%"
521300,Go-Maurilandia,202503,2070,1346,1601,5017,10.239,"49,00%","20,22%"
521305,Go-Mimoso de Goias,202503,865,360,585,1810,2.633,"68,74%","32,85%"
521308,Go-Minacu,202503,4642,3802,5254,13698,26.939,"50,85%","17,23%"
521310,Go-Mineiros,202503,9186,11050,15425,35661,73.781,"48,33%","12,45%"
521340,Go-Moipora,202503,330,289,456,1075,1.693,"63,50%","19,49%"
521350,Go-Monte Alegre de Goias,202503,3442,997,1142,5581,6.613,"84,39%","52,05%"
521370,Go-Montes Claros de Goias,202503,1113,1386,1405,3904,8.972,"43,51%","12,41%"
521375,Go-Montividiu,202503,1623,1872,2357,5852,12.957,"45,16%","12,53%"
521377,Go-Montividiu do Norte,202503,1694,555,723,2972,3.770,"78,83%","44,93%"
521380,Go-Morrinhos,202503,3098,8949,9108,21155,53.640,"39,44%","5,78%"
521385,Go-Morro Agudo de Goias,202503,882,458,586,1926,2.499,"77,07%","35,29%"
521390,Go-Mossamedes,202503,557,1033,763,2353,4.655,"50,55%","11,97%"
521400,Go-Mozarlandia,202503,4327,1803,2535,8665,15.109,"57,35%","28,64%"
521405,Go-Mundo Novo,202503,1195,1093,1713,4001,6.223,"64,29%","19,20%"
521410,Go-Mutunopolis,202503,1352,472,539,2363,3.562,"66,34%","37,96%"
521440,Go-Nazario,202503,1573,1286,1355,4214,8.330,"50,59%","18,88%"
521450,Go-Neropolis,202503,5650,5293,5061,16004,33.706,"47,48%","16,76%"
521460,Go-Niquelandia,202503,4891,6520,9552,20963,34.466,"60,82%","14,19%"
521470,Go-Nova America,202503,994,593,952,2539,2.375,"106,91%","41,85%"
521480,Go-Nova Aurora,202503,375,365,626,1366,2.130,"64,13%","17,61%"
521483,Go-Nova Crixas,202503,3191,1626,1590,6407,13.095,"48,93%","24,37%"
521486,Go-Nova Gloria,202503,2147,1113,1291,4551,8.375,"54,34%","25,64%"
521487,Go-Nova Iguacu de Goias,202503,655,278,324,1257,3.072,"40,92%","21,32%"
521490,Go-Nova Roma,202503,1056,585,659,2300,3.053,"75,34%","34,59%"
521500,Go-Nova Veneza,202503,2248,1966,1801,6015,9.790,"61,44%","22,96%"
521520,Go-Novo Brasil,202503,1073,488,611,2172,3.568,"60,87%","30,07%"
521523,Go-Novo Gama,202503,23642,14710,12252,50604,107.092,"47,25%","22,08%"
521525,Go-Novo Planalto,202503,1260,730,823,2813,3.723,"75,56%","33,84%"
521530,Go-Orizona,202503,1938,2265,2569,6772,16.890,"40,09%","11,47%"
521540,Go-Ouro Verde de Goias,202503,948,602,517,2067,4.108,"50,32%","23,08%"
521550,Go-Ouvidor,202503,912,1416,3210,5538,7.542,"73,43%","12,09%"
521560,Go-Padre Bernardo,202503,7247,5262,4819,17328,36.692,"47,23%","19,75%"
521565,Go-Palestina de Goias,202503,708,435,728,1871,3.132,"59,74%","22,61%"
521570,Go-Palmeiras de Goias,202503,4715,5103,5491,15309,33.749,"45,36%","13,97%"
521580,Go-Palmelo,202503,429,394,560,1383,2.273,"60,84%","18,87%"
521590,Go-Palminopolis,202503,1033,607,710,2350,3.939,"59,66%","26,22%"
521600,Go-Panama,202503,474,377,620,1471,2.449,"60,07%","19,35%"
521630,Go-Paranaiguara,202503,1340,1122,1547,4009,7.470,"53,67%","17,94%"
521640,Go-Parauna,202503,1894,1620,1942,5456,10.749,"50,76%","17,62%"
521645,Go-Perolandia,202503,344,606,818,1768,3.000,"58,93%","11,47%"
521680,Go-Petrolina de Goias,202503,1806,1237,1203,4246,9.577,"44,34%","18,86%"
521690,Go-Pilar de Goias,202503,631,377,319,1327,2.288,"58,00%","27,58%"
521710,Go-Piracanjuba,202503,4156,2705,3265,10126,25.309,"40,01%","16,42%"
521720,Go-Piranhas,202503,1979,1686,2634,6299,11.913,"52,88%","16,61%"
521730,Go-Pirenopolis,202503,3468,5405,5439,14312,27.757,"51,56%","12,49%"
521740,Go-Pires do Rio,202503,5023,4924,4903,14850,33.494,"44,34%","15,00%"
521760,Go-Planaltina,202503,31614,13224,11883,56721,110.619,"51,28%","28,58%"
521770,Go-Pontalina,202503,1771,3707,3412,8890,18.685,"47,58%","9,48%"
521800,Go-Porangatu,202503,7517,6837,7090,21444,45.400,"47,23%","16,56%"
521805,Go-Porteirao,202503,949,726,1188,2863,4.225,"67,76%","22,46%"
521810,Go-Portelandia,202503,1059,464,709,2232,3.234,"69,02%","32,75%"
521830,Go-Posse,202503,9580,4672,4131,18383,36.060,"50,98%","26,57%"
521839,Go-Professor Jamil,202503,1209,528,772,2509,3.732,"67,23%","32,40%"
521850,Go-Quirinopolis,202503,5011,7701,8554,21266,49.986,"42,54%","10,02%"
521860,Go-Rialma,202503,1566,1914,2345,5825,12.551,"46,41%","12,48%"
521870,Go-Rianapolis,202503,833,836,1053,2722,3.938,"69,12%","21,15%"
521878,Go-Rio Quente,202503,750,823,1304,2877,3.994,"72,03%","18,78%"
521880,Go-Rio Verde,202503,29191,25689,27679,82559,238.025,"34,69%","12,26%"
521890,Go-Rubiataba,202503,2333,3180,4220,9733,20.132,"48,35%","11,59%"
521900,Go-Sanclerlandia,202503,1173,1233,1869,4275,8.063,"53,02%","14,55%"
521910,Go-Santa Barbara de Goias,202503,1489,1087,1028,3604,6.280,"57,39%","23,71%"
521920,Go-Santa Cruz de Goias,202503,686,445,515,1646,3.016,"54,58%","22,75%"
521925,Go-Santa Fe de Goias,202503,980,530,804,2314,5.036,"45,95%","19,46%"
521930,Go-Santa Helena de Goias,202503,6575,3976,5035,15586,39.481,"39,48%","16,65%"
521935,Go-Santa Isabel,202503,1142,597,859,2598,3.556,"73,06%","32,11%"
521940,Go-Santa Rita do Araguaia,202503,1501,761,1091,3353,5.842,"57,39%","25,69%"
521945,Go-Santa Rita do Novo Destino,202503,828,398,903,2129,2.648,"80,40%","31,27%"
521950,Go-Santa Rosa de Goias,202503,773,533,577,1883,2.837,"66,37%","27,25%"
521960,Go-Santa Tereza de Goias,202503,721,448,635,1804,3.225,"55,94%","22,36%"
521970,Go-Santa Terezinha de Goias,202503,2961,1851,1622,6434,10.818,"59,47%","27,37%"
521971,Go-Santo Antonio da Barra,202503,497,788,1071,2356,4.293,"54,88%","11,58%"
521973,Go-Santo Antonio de Goias,202503,1778,1461,1771,5010,7.873,"63,64%","22,58%"
521975,Go-Santo Antonio do Descoberto,202503,22279,10279,11004,43562,74.614,"58,38%","29,86%"
521980,Go-Sao Domingos,202503,3337,1244,1573,6154,9.581,"64,23%","34,83%"
521990,Go-Sao Francisco de Goias,202503,2121,935,1131,4187,6.491,"64,50%","32,68%"
522000,Go-Sao Joao D Alianca,202503,3309,2369,1826,7504,14.757,"50,85%","22,42%"
522005,Go-Sao Joao da Parauna,202503,372,263,393,1028,1.807,"56,89%","20,59%"
522010,Go-Sao Luis de Montes Belos,202503,4806,4575,5419,14800,35.031,"42,25%","13,72%"
522015,Go-Sao Luiz do Norte,202503,1554,835,748,3137,4.926,"63,68%","31,55%"
522020,Go-Sao Miguel do Araguaia,202503,6079,3401,4970,14450,22.079,"65,45%","27,53%"
522026,Go-Sao Miguel do Passa Quatro,202503,805,666,799,2270,4.621,"49,12%","17,42%"
522028,Go-Sao Patricio,202503,545,382,530,1457,2.190,"66,53%","24,89%"
522040,Go-Sao Simao,202503,3322,2391,3974,9687,17.194,"56,34%","19,32%"
522045,Go-Senador Canedo,202503,20368,28562,22651,71581,169.849,"42,14%","11,99%"
522050,Go-Serranopolis,202503,1406,985,1097,3488,8.201,"42,53%","17,14%"
522060,Go-Silvania,202503,4196,3073,3283,10552,22.939,"46,00%","18,29%"
522068,Go-Simolandia,202503,2325,1041,957,4323,5.693,"75,94%","40,84%"
522070,Go-Sitio D Abadia,202503,1518,311,465,2294,2.973,"77,16%","51,06%"
522100,Go-Taquaral de Goias,202503,846,837,884,2567,4.146,"61,92%","20,41%"
522108,Go-Teresina de Goias,202503,2063,416,654,3133,2.685,"116,69%","76,83%"
522119,Go-Terezopolis de Goias,202503,2952,1041,1063,5056,8.243,"61,34%","35,81%"
522130,Go-Tres Ranchos,202503,793,334,426,1553,2.970,"52,29%","26,70%"
522140,Go-Trindade,202503,23890,26606,28738,79234,150.858,"52,52%","15,84%"
522145,Go-Trombas,202503,930,420,567,1917,3.106,"61,72%","29,94%"
522150,Go-Turvania,202503,766,945,1102,2813,4.478,"62,82%","17,11%"
522155,Go-Turvelandia,202503,1236,549,704,2489,5.130,"48,52%","24,09%"
522157,Go-Uirapuru,202503,1074,371,478,1923,2.809,"68,46%","38,23%"
522160,Go-Uruacu,202503,4033,7122,7873,19028,44.150,"43,10%","9,13%"
522170,Go-Uruana,202503,4447,1903,1911,8261,13.871,"59,56%","32,06%"
522180,Go-Urutai,202503,539,682,868,2089,3.667,"56,97%","14,70%"
522185,Go-Valparaiso de Goias,202503,26511,27501,19934,73946,213.506,"34,63%","12,42%"
522190,Go-Varjao,202503,813,645,689,2147,3.768,"56,98%","21,58%"
522200,Go-Vianopolis,202503,2452,2357,2513,7322,15.476,"47,31%","15,84%"
522205,Go-Vicentinopolis,202503,1738,1459,1394,4591,9.077,"50,58%","19,15%"
522220,Go-Vila Boa,202503,1473,813,900,3186,4.185,"76,13%","35,20%"
522230,Go-Vila Propicio,202503,1585,953,1271,3809,5.982,"63,67%","26,50%"
530010,Df-Brasilia,202503,458536,252454,213392,924382,2.982.818,"30,99%","15,37%"
